League,Team,Overall_Scored_4+,Overall_Scored_3,Overall_Scored_2,Overall_Scored_1,Overall_Scored_0,Overall_Scored_Avg,Overall_Conceded_Avg,Overall_Conceded_0,Overall_Conceded_1,Overall_Conceded_2,Overall_Conceded_3,Overall_Conceded_4+,Home_Scored_4+,Home_Scored_3,Home_Scored_2,Home_Scored_1,Home_Scored_0,Home_Scored_Avg,Home_Conceded_Avg,Home_Conceded_0,Home_Conceded_1,Home_Conceded_2,Home_Conceded_3,Home_Conceded_4+,Away_Scored_4+,Away_Scored_3,Away_Scored_2,Away_Scored_1,Away_Scored_0,Away_Scored_Avg,Away_Conceded_Avg,Away_Conceded_0,Away_Conceded_1,Away_Conceded_2,Away_Conceded_3,Away_Conceded_4+
Argentina - Liga Profesional,A. Tucuman,1,1,1,7,6,1.06,1.31,4,5,5,2,0,1,1,1,3,2,1.63,1.25,3,1,3,1,0,0,0,0,4,4,0.5,1.38,1,4,2,1,0
Argentina - Liga Profesional,Aldosivi,0,2,5,2,7,1.13,1.75,2,5,6,2,1,0,0,4,1,3,1.13,2.25,0,2,4,1,1,0,2,1,1,4,1.13,1.25,2,3,2,1,0
Argentina - Liga Profesional,Argentinos Jrs,2,2,2,6,4,1.5,0.56,9,5,2,0,0,2,1,1,3,2,1.78,0.44,6,2,1,0,0,0,1,1,3,2,1.14,0.71,3,3,1,0,0
Argentina - Liga Profesional,Banfield,0,2,0,8,6,0.88,1.19,4,8,2,1,1,0,2,0,3,3,1.13,0.75,3,4,1,0,0,0,0,0,5,3,0.63,1.63,1,4,1,1,1
Argentina - Liga Profesional,Barracas C.,0,2,3,8,3,1.25,1.13,5,7,1,3,0,0,1,3,4,0,1.63,1.25,3,2,1,2,0,0,1,0,4,3,0.88,1.0,2,5,0,1,0
Argentina - Liga Profesional,Belgrano,0,0,2,9,5,0.81,1.44,5,6,0,3,2,0,0,2,5,1,1.13,1.25,2,4,0,2,0,0,0,0,4,4,0.5,1.63,3,2,0,1,2
Argentina - Liga Profesional,Boca Juniors,1,2,4,6,3,1.5,0.69,8,5,3,0,0,1,0,4,2,1,1.75,0.25,6,2,0,0,0,0,2,0,4,2,1.25,1.13,2,3,3,0,0
Argentina - Liga Profesional,Central Cordoba,1,1,4,6,4,1.31,1.38,5,4,3,4,0,1,0,2,4,2,1.33,0.89,5,1,2,1,0,0,1,2,2,2,1.29,2.0,0,3,1,3,0
Argentina - Liga Profesional,D. Riestra,0,2,1,5,8,0.81,0.44,12,2,1,1,0,0,1,0,2,5,0.63,0.13,7,1,0,0,0,0,1,1,3,3,1.0,0.75,5,1,1,1,0
Argentina - Liga Profesional,Defensa y J.,1,0,2,9,4,1.13,1.38,5,5,3,1,2,0,0,1,4,2,0.86,1.0,2,3,2,0,0,1,0,1,5,2,1.33,1.67,3,2,1,1,2
Argentina - Liga Profesional,Estudiantes,0,2,4,4,6,1.13,1.19,5,5,5,0,1,0,2,1,2,2,1.43,0.71,3,3,1,0,0,0,0,3,2,4,0.89,1.56,2,2,4,0,1
Argentina - Liga Profesional,Gimnasia,0,1,0,6,9,0.56,1.13,6,4,4,2,0,0,1,0,4,3,0.88,0.88,4,2,1,1,0,0,0,0,2,6,0.25,1.38,2,2,3,1,0
Argentina - Liga Profesional,Godoy Cruz,0,0,2,4,10,0.5,1.13,7,5,0,3,1,0,0,0,3,5,0.38,0.63,5,2,0,1,0,0,0,2,1,5,0.63,1.63,2,3,0,2,1
Argentina - Liga Profesional,Huracan,0,1,5,6,4,1.19,0.75,8,5,2,1,0,0,1,3,2,2,1.38,0.63,5,2,0,1,0,0,0,2,4,2,1.0,0.88,3,3,2,0,0
Argentina - Liga Profesional,I. Rivadavia,0,2,4,6,4,1.25,1.06,6,5,4,0,1,0,1,3,3,1,1.5,1.25,3,2,2,0,1,0,1,1,3,3,1.0,0.88,3,3,2,0,0
Argentina - Liga Profesional,Independiente,1,2,5,3,5,1.44,0.75,7,6,3,0,0,1,1,4,1,1,2.0,0.25,6,2,0,0,0,0,1,1,2,4,0.88,1.25,1,4,3,0,0
Argentina - Liga Profesional,Instituto,0,2,3,4,7,1.0,1.25,5,6,2,2,1,0,2,1,3,1,1.57,0.43,4,3,0,0,0,0,0,2,1,6,0.56,1.89,1,3,2,2,1
Argentina - Liga Profesional,Lanus,1,0,1,7,7,0.81,0.69,7,7,2,0,0,1,0,1,3,3,1.13,0.63,4,3,1,0,0,0,0,0,4,4,0.5,0.75,3,4,1,0,0
Argentina - Liga Profesional,Newells,0,0,4,4,8,0.75,0.94,6,6,3,1,0,0,0,2,2,4,0.75,0.5,5,2,1,0,0,0,0,2,2,4,0.75,1.38,1,4,2,1,0
Argentina - Liga Profesional,Platense,0,0,3,7,6,0.81,0.69,6,9,1,0,0,0,0,2,3,3,0.88,0.63,3,5,0,0,0,0,0,1,4,3,0.75,0.75,3,4,1,0,0
Argentina - Liga Profesional,Racing Club,2,1,5,5,3,1.63,1.0,6,6,2,2,0,2,0,2,2,1,2.0,0.71,4,2,0,1,0,0,1,3,3,2,1.33,1.22,2,4,2,1,0
Argentina - Liga Profesional,River Plate,1,1,4,6,4,1.31,0.56,9,5,2,0,0,1,0,3,4,1,1.56,0.78,4,3,2,0,0,0,1,1,2,3,1.0,0.29,5,2,0,0,0
Argentina - Liga Profesional,Rosario Central,0,3,5,3,5,1.38,0.5,9,6,1,0,0,0,2,3,2,0,2.0,0.57,3,4,0,0,0,0,1,2,1,5,0.89,0.44,6,2,1,0,0
Argentina - Liga Profesional,SM San Juan,0,1,0,2,13,0.31,1.13,3,9,3,1,0,0,1,0,1,7,0.44,1.22,2,4,2,1,0,0,0,0,1,6,0.14,1.0,1,5,1,0,0
Argentina - Liga Profesional,San Lorenzo,0,1,2,7,6,0.88,0.63,9,4,3,0,0,0,1,1,4,2,1.13,0.88,3,3,2,0,0,0,0,1,3,4,0.63,0.38,6,1,1,0,0
Argentina - Liga Profesional,Sarmiento,0,0,2,7,7,0.69,1.19,4,8,3,0,1,0,0,1,4,3,0.75,0.75,2,6,0,0,0,0,0,1,3,4,0.63,1.63,2,2,3,0,1
Argentina - Liga Profesional,T. de Cordoba,0,0,2,7,7,0.69,0.94,6,6,3,1,0,0,0,2,3,3,0.88,1.25,2,3,2,1,0,0,0,0,4,4,0.5,0.63,4,3,1,0,0
Argentina - Liga Profesional,Tigre,1,1,3,5,6,1.13,0.75,7,6,3,0,0,0,1,0,5,2,1.0,0.63,5,1,2,0,0,1,0,3,0,4,1.25,0.88,2,5,1,0,0
Argentina - Liga Profesional,Union Santa Fe,0,1,0,8,7,0.69,1.06,4,8,3,1,0,0,1,0,5,3,0.89,0.67,3,6,0,0,0,0,0,0,3,4,0.43,1.57,1,2,3,1,0
Argentina - Liga Profesional,Velez Sarsfield,0,0,1,5,10,0.44,1.38,5,4,4,2,1,0,0,0,2,6,0.25,0.88,3,3,2,0,0,0,0,1,3,4,0.63,1.88,2,1,2,2,1
Argentina - Primera Nacional,A. Atlanta,1,1,2,10,9,0.91,0.65,13,6,3,1,0,1,1,2,5,2,1.45,0.45,7,3,1,0,0,0,0,0,5,7,0.42,0.83,6,3,2,1,0
Argentina - Primera Nacional,Agropecuario,0,2,5,10,6,1.13,1.17,6,10,4,3,0,0,1,5,5,1,1.5,0.67,5,6,1,0,0,0,1,0,5,5,0.73,1.73,1,4,3,3,0
Argentina - Primera Nacional,All Boys,1,1,2,7,12,0.78,0.91,9,9,3,2,0,1,1,2,1,6,1.09,0.64,5,5,1,0,0,0,0,0,6,6,0.5,1.17,4,4,2,2,0
Argentina - Primera Nacional,Almagro,0,0,2,13,8,0.74,0.87,8,11,3,1,0,0,0,1,5,6,0.58,0.42,7,5,0,0,0,0,0,1,8,2,0.91,1.36,1,6,3,1,0
Argentina - Primera Nacional,Almirante Brown,0,0,4,8,11,0.7,1.13,7,10,4,1,1,0,0,2,4,6,0.67,0.75,6,4,1,1,0,0,0,2,4,5,0.73,1.55,1,6,3,0,1
Argentina - Primera Nacional,Alvarado,0,1,2,6,13,0.59,1.0,8,7,6,1,0,0,1,1,2,7,0.64,0.91,4,4,3,0,0,0,0,1,4,6,0.55,1.09,4,3,3,1,0
Argentina - Primera Nacional,Arsenal Sarandi,0,1,3,9,10,0.78,1.43,3,12,4,3,1,0,0,2,3,6,0.64,1.0,2,7,2,0,0,0,1,1,6,4,0.92,1.83,1,5,2,3,1
Argentina - Primera Nacional,Atletico Mitre,0,2,3,4,13,0.73,0.73,11,6,5,0,0,0,1,1,3,6,0.73,0.55,6,4,1,0,0,0,1,2,1,7,0.73,0.91,5,2,4,0,0
Argentina - Primera Nacional,CA Estudiantes,1,0,3,10,9,0.91,0.78,10,8,5,0,0,1,0,2,2,6,1.0,0.82,5,3,3,0,0,0,0,1,8,3,0.83,0.75,5,5,2,0,0
Argentina - Primera Nacional,CA Guemes,0,0,4,11,8,0.83,0.96,5,15,2,1,0,0,0,3,7,2,1.08,0.75,3,9,0,0,0,0,0,1,4,6,0.55,1.18,2,6,2,1,0
Argentina - Primera Nacional,Central Norte,0,2,3,8,10,0.87,1.26,6,9,6,0,2,0,2,3,5,2,1.42,1.17,4,4,3,0,1,0,0,0,3,8,0.27,1.36,2,5,3,0,1
Argentina - Primera Nacional,Chacarita J.,1,4,4,6,8,1.3,0.74,11,8,3,1,0,1,2,2,2,5,1.33,1.08,4,4,3,1,0,0,2,2,4,3,1.27,0.36,7,4,0,0,0
Argentina - Primera Nacional,Chaco For Ever,0,1,8,6,8,1.09,0.78,11,6,6,0,0,0,0,5,4,2,1.27,0.55,6,4,1,0,0,0,1,3,2,6,0.92,1.0,5,2,5,0,0
Argentina - Primera Nacional,Colegiales,0,0,3,7,13,0.57,0.83,11,8,2,1,1,0,0,2,4,5,0.73,0.45,6,5,0,0,0,0,0,1,3,8,0.42,1.17,5,3,2,1,1
Argentina - Primera Nacional,Colon Santa Fe,1,0,4,8,9,0.91,1.09,7,8,5,2,0,0,0,3,2,5,0.8,0.5,5,5,0,0,0,1,0,1,6,4,1.0,1.58,2,3,5,2,0
Argentina - Primera Nacional,D. Madryn,0,2,4,11,5,1.14,0.86,6,13,3,0,0,0,1,3,5,1,1.4,0.8,3,6,1,0,0,0,1,1,6,4,0.92,0.92,3,7,2,0,0
Argentina - Primera Nacional,D. de Belgrano,0,1,3,9,9,0.82,0.68,10,9,3,0,0,0,0,1,5,5,0.64,0.73,5,4,2,0,0,0,1,2,4,4,1.0,0.64,5,5,1,0,0
Argentina - Primera Nacional,Defensores U.,0,0,1,7,15,0.39,1.65,3,8,7,4,1,0,0,1,4,6,0.55,1.45,1,5,4,1,0,0,0,0,3,9,0.25,1.83,2,3,3,3,1
Argentina - Primera Nacional,Deportivo Maipu,0,2,3,10,8,0.96,0.91,7,12,3,1,0,0,2,2,4,3,1.27,0.73,3,8,0,0,0,0,0,1,6,5,0.67,1.08,4,4,3,1,0
Argentina - Primera Nacional,Deportivo Moron,1,1,5,8,7,1.14,0.5,11,11,0,0,0,1,1,3,4,1,1.7,0.3,7,3,0,0,0,0,0,2,4,6,0.67,0.67,4,8,0,0,0
Argentina - Primera Nacional,E. Rio Cuarto,0,0,6,11,6,1.0,0.61,11,10,2,0,0,0,0,1,8,2,0.91,0.55,5,6,0,0,0,0,0,5,3,4,1.08,0.67,6,4,2,0,0
Argentina - Primera Nacional,Ferro Carril,0,0,4,7,12,0.65,0.96,9,9,3,1,1,0,0,3,3,6,0.75,0.42,8,3,1,0,0,0,0,1,4,6,0.55,1.55,1,6,2,1,1
Argentina - Primera Nacional,G. Mendoza,0,0,5,12,5,1.0,0.5,12,9,1,0,0,0,0,3,7,2,1.08,0.5,6,6,0,0,0,0,0,2,5,3,0.9,0.5,6,3,1,0,0
Argentina - Primera Nacional,Gimnasia Jujuy,0,1,5,11,6,1.04,0.48,14,7,2,0,0,0,0,4,4,4,1.0,0.5,7,4,1,0,0,0,1,1,7,2,1.09,0.45,7,3,1,0,0
Argentina - Primera Nacional,Gimnasia y Tiro,1,0,3,10,9,0.87,0.61,11,10,2,0,0,1,0,3,6,1,1.45,0.55,6,4,1,0,0,0,0,0,4,8,0.33,0.67,5,6,1,0,0
Argentina - Primera Nacional,Los Andes,0,2,3,10,8,0.96,0.96,9,8,4,2,0,0,2,3,5,2,1.42,0.75,7,3,0,2,0,0,0,0,5,6,0.45,1.18,2,5,4,0,0
Argentina - Primera Nacional,Nueva Chicago,0,0,5,11,7,0.91,0.91,9,7,7,0,0,0,0,3,5,4,0.92,0.75,6,3,3,0,0,0,0,2,6,3,0.91,1.09,3,4,4,0,0
Argentina - Primera Nacional,Patronato,0,4,2,11,6,1.17,0.91,8,10,4,1,0,0,3,2,2,5,1.25,0.58,6,5,1,0,0,0,1,0,9,1,1.09,1.27,2,5,3,1,0
Argentina - Primera Nacional,Quilmes,0,3,3,7,8,1.05,0.9,8,7,6,0,0,0,3,2,5,1,1.64,0.91,3,6,2,0,0,0,0,1,2,7,0.4,0.9,5,1,4,0,0
Argentina - Primera Nacional,Racing Cordoba,1,1,6,10,5,1.26,1.3,5,11,3,3,1,1,1,4,4,2,1.58,1.0,3,7,1,1,0,0,0,2,6,3,0.91,1.64,2,4,2,2,1
Argentina - Primera Nacional,SM Tucuman,0,0,4,14,5,0.96,0.61,12,9,1,1,0,0,0,1,8,3,0.83,0.58,5,7,0,0,0,0,0,3,6,2,1.09,0.64,7,2,1,1,0
Argentina - Primera Nacional,San Miguel,0,0,5,12,6,0.96,0.65,12,7,4,0,0,0,0,5,6,1,1.33,0.5,7,4,1,0,0,0,0,0,6,5,0.55,0.82,5,3,3,0,0
Argentina - Primera Nacional,San Telmo,0,1,5,7,9,0.91,1.09,7,9,3,3,0,0,1,1,3,7,0.67,1.33,4,3,2,3,0,0,0,4,4,2,1.2,0.8,3,6,1,0,0
Argentina - Primera Nacional,Talleres R. E.,0,0,1,5,17,0.3,1.22,5,10,6,2,0,0,0,1,2,8,0.36,1.18,3,4,3,1,0,0,0,0,3,9,0.25,1.25,2,6,3,1,0
Argentina - Primera Nacional,Temperley,0,2,5,6,10,0.96,0.74,14,2,6,1,0,0,1,4,4,2,1.36,0.82,6,2,2,1,0,0,1,1,2,8,0.58,0.67,8,0,4,0,0
Argentina - Primera Nacional,Tristan Suarez,0,1,4,8,10,0.83,0.65,11,9,3,0,0,0,1,3,2,5,1.0,0.45,6,5,0,0,0,0,0,1,6,5,0.67,0.83,5,4,3,0,0
Argentina - Primera B,A. Quilmes,0,1,7,4,8,1.05,1.2,6,7,6,0,1,0,1,3,3,3,1.2,0.7,4,5,1,0,0,0,0,4,1,5,0.9,1.7,2,2,5,0,1
Argentina - Primera B,Acassuso,1,1,4,9,5,1.25,0.9,7,9,3,1,0,1,0,1,5,3,1.2,0.8,4,4,2,0,0,0,1,3,4,2,1.3,1.0,3,5,1,1,0
Argentina - Primera B,Argentino Merlo,0,2,7,5,6,1.25,0.75,10,6,3,1,0,0,1,2,4,3,1.1,0.9,4,3,3,0,0,0,1,5,1,3,1.4,0.6,6,3,0,1,0
Argentina - Primera B,Brown de A.,1,0,3,8,8,0.9,0.85,9,6,4,1,0,1,0,2,2,5,1.0,0.9,4,4,1,1,0,0,0,1,6,3,0.8,0.8,5,2,3,0,0
Argentina - Primera B,Comunicaciones,0,1,6,4,9,0.95,0.9,8,7,4,1,0,0,1,3,2,4,1.1,0.8,4,4,2,0,0,0,0,3,2,5,0.8,1.0,4,3,2,1,0
Argentina - Primera B,D. Armenio,1,1,0,10,8,0.85,0.95,7,10,1,1,1,1,1,0,4,4,1.1,1.0,5,3,0,1,1,0,0,0,6,4,0.6,0.9,2,7,1,0,0
Argentina - Primera B,D. Laferrere,0,2,6,3,9,1.05,1.0,9,4,5,2,0,0,2,4,1,3,1.5,0.9,6,1,1,2,0,0,0,2,2,6,0.6,1.1,3,3,4,0,0
Argentina - Primera B,Deportivo Merlo,0,1,2,9,8,0.8,0.85,9,6,4,1,0,0,1,0,5,4,0.8,0.8,5,2,3,0,0,0,0,2,4,4,0.8,0.9,4,4,1,1,0
Argentina - Primera B,Dock Sud,0,4,3,11,2,1.45,1.25,5,8,5,1,1,0,3,1,5,1,1.6,0.9,3,5,2,0,0,0,1,2,6,1,1.3,1.6,2,3,3,1,1
Argentina - Primera B,Excursionistas,0,2,3,9,6,1.05,0.8,10,5,4,1,0,0,2,1,5,2,1.3,0.3,7,3,0,0,0,0,0,2,4,4,0.8,1.3,3,2,4,1,0
Argentina - Primera B,Fenix,0,0,1,6,13,0.4,1.45,5,6,6,2,1,0,0,0,4,6,0.4,0.9,4,3,3,0,0,0,0,1,2,7,0.4,2.0,1,3,3,2,1
Argentina - Primera B,Flandria,0,0,2,8,10,0.6,0.9,9,6,3,2,0,0,0,1,6,3,0.8,0.6,5,4,1,0,0,0,0,1,2,7,0.4,1.2,4,2,2,2,0
Argentina - Primera B,Liniers,2,3,1,7,7,1.35,1.1,6,8,4,2,0,2,0,1,3,4,1.4,1.1,4,2,3,1,0,0,3,0,4,3,1.3,1.1,2,6,1,1,0
Argentina - Primera B,Midland,0,2,7,4,7,1.2,0.25,15,5,0,0,0,0,2,5,0,3,1.6,0.1,9,1,0,0,0,0,0,2,4,4,0.8,0.4,6,4,0,0,0
Argentina - Primera B,Real Pilar,1,2,6,4,7,1.35,0.8,9,7,3,1,0,1,2,3,2,2,1.9,0.9,4,4,1,1,0,0,0,3,2,5,0.8,0.7,5,3,2,0,0
Argentina - Primera B,S. Italiano,0,0,5,5,10,0.75,0.8,8,8,4,0,0,0,0,4,1,5,0.9,0.6,5,4,1,0,0,0,0,1,4,5,0.6,1.0,3,4,3,0,0
Argentina - Primera B,SM Burzaco,1,0,3,9,7,0.95,1.25,5,8,6,0,1,1,0,1,5,3,1.1,0.7,5,3,2,0,0,0,0,2,4,4,0.8,1.8,0,5,4,0,1
Argentina - Primera B,Sacachispas,0,1,1,8,10,0.65,1.2,6,7,4,3,0,0,0,1,6,3,0.8,1.0,3,5,1,1,0,0,1,0,2,7,0.5,1.4,3,2,3,2,0
Argentina - Primera B,UAI Urquiza,0,0,4,8,8,0.8,0.9,8,7,4,1,0,0,0,3,4,3,1.0,1.0,3,4,3,0,0,0,0,1,4,5,0.6,0.8,5,3,1,1,0
Argentina - Primera B,V. San Carlos,0,0,8,8,4,1.2,1.4,4,8,5,2,1,0,0,7,2,1,1.6,1.2,1,6,3,0,0,0,0,1,6,3,0.8,1.6,3,2,2,2,1
Argentina - Primera B,Villa Dalmine,1,1,3,7,8,1.0,1.35,5,8,4,1,2,0,1,2,3,4,1.0,1.2,2,4,4,0,0,1,0,1,4,4,1.0,1.5,3,4,0,1,2
Argentina - Torneo Federal,9 Julio Rafaela,1,1,3,7,6,1.11,1.17,5,8,3,1,1,1,1,3,2,2,1.67,1.11,3,4,1,0,1,0,0,0,5,4,0.56,1.22,2,4,2,1,0
Argentina - Torneo Federal,A. Rafaela,0,1,6,6,4,1.24,0.94,7,6,2,2,0,0,1,4,3,1,1.56,0.44,5,4,0,0,0,0,0,2,3,3,0.88,1.5,2,2,2,2,0
Argentina - Torneo Federal,Argentino MM,0,1,2,9,5,0.94,1.06,7,5,3,1,1,0,1,1,4,2,1.13,0.63,4,3,1,0,0,0,0,1,5,3,0.78,1.44,3,2,2,1,1
Argentina - Torneo Federal,Atenas,1,1,3,4,8,1.0,0.82,7,7,2,1,0,1,0,0,4,4,0.89,0.56,5,3,1,0,0,0,1,3,0,4,1.13,1.13,2,4,1,1,0
Argentina - Torneo Federal,Bartolome Mitre,0,2,2,5,7,0.94,0.81,6,8,1,1,0,0,0,1,4,3,0.75,0.5,4,4,0,0,0,0,2,1,1,4,1.13,1.13,2,4,1,1,0
Argentina - Torneo Federal,Ben Hur,0,1,4,6,8,0.89,1.11,6,6,6,1,0,0,1,3,3,2,1.33,0.56,5,3,1,0,0,0,0,1,3,6,0.5,1.6,1,3,5,1,0
Argentina - Torneo Federal,Boca Unidos,0,1,5,6,5,1.12,1.59,3,4,7,3,0,0,0,5,1,2,1.38,1.5,2,1,4,1,0,0,1,0,5,3,0.89,1.67,1,3,3,2,0
Argentina - Torneo Federal,Cipolletti,1,3,7,4,3,1.72,0.72,8,8,1,1,0,1,3,2,2,1,2.11,0.56,5,3,1,0,0,0,0,5,2,2,1.33,0.89,3,5,0,1,0
Argentina - Torneo Federal,Circulo D.,1,0,3,6,9,0.89,1.11,6,7,5,0,1,0,0,2,3,5,0.7,0.8,4,4,2,0,0,1,0,1,3,4,1.11,1.44,2,3,3,0,1
Argentina - Torneo Federal,Ciudad Bolivar,2,1,5,5,4,1.53,0.53,9,7,1,0,0,2,1,4,1,1,2.22,0.33,6,3,0,0,0,0,0,1,4,3,0.75,0.75,3,4,1,0,0
Argentina - Torneo Federal,Costa Brava,0,2,1,10,4,1.06,0.41,11,5,1,0,0,0,2,0,7,0,1.44,0.22,7,2,0,0,0,0,0,1,3,4,0.63,0.63,4,3,1,0,0
Argentina - Torneo Federal,Crucero del N.,0,1,1,5,10,0.59,1.76,4,5,3,2,3,0,1,0,3,4,0.75,1.38,1,4,2,1,0,0,0,1,2,6,0.44,2.11,3,1,1,1,3
Argentina - Torneo Federal,D. Belgrano VR,0,0,1,8,10,0.53,0.79,8,7,4,0,0,0,0,1,5,4,0.7,0.8,3,6,1,0,0,0,0,0,3,6,0.33,0.78,5,1,3,0,0
Argentina - Torneo Federal,D. Rincon,0,2,5,6,6,1.16,1.16,8,3,6,1,1,0,1,4,3,1,1.56,0.89,6,0,2,0,1,0,1,1,3,5,0.8,1.4,2,3,4,1,0
Argentina - Torneo Federal,Douglas Haig,0,2,3,6,8,0.95,0.68,10,6,2,1,0,0,0,2,4,4,0.8,0.6,5,4,1,0,0,0,2,1,2,4,1.11,0.78,5,2,1,1,0
Argentina - Torneo Federal,El Linqueno,0,1,3,7,7,0.89,1.11,6,7,2,3,0,0,1,1,3,4,0.89,0.67,5,3,0,1,0,0,0,2,4,3,0.89,1.56,1,4,2,2,0
Argentina - Torneo Federal,G. Chivilcoy,0,0,6,6,7,0.95,0.84,9,5,4,1,0,0,0,5,4,0,1.56,1.11,2,5,1,1,0,0,0,1,2,7,0.4,0.6,7,0,3,0,0
Argentina - Torneo Federal,Germinal,0,1,3,7,8,0.84,1.58,2,9,5,2,1,0,1,1,4,3,1.0,1.89,0,5,2,1,1,0,0,2,3,5,0.7,1.3,2,4,3,1,0
Argentina - Torneo Federal,Gimnasia E.,0,2,2,4,11,0.74,1.21,8,3,5,2,1,0,2,2,1,5,1.1,0.7,7,0,2,1,0,0,0,0,3,6,0.33,1.78,1,3,3,1,1
Argentina - Torneo Federal,Guillermo Brown,1,1,4,6,7,1.11,1.53,4,8,3,1,3,0,1,2,4,3,1.1,1.1,3,5,1,0,1,1,0,2,2,4,1.11,2.0,1,3,2,1,2
Argentina - Torneo Federal,Gutierrez,1,0,1,5,10,0.71,2.06,1,7,2,4,3,1,0,0,3,4,1.0,1.75,1,3,2,1,1,0,0,1,2,6,0.44,2.33,0,4,0,3,2
Argentina - Torneo Federal,Huracan Las H.,0,0,4,8,5,0.94,1.18,4,9,2,1,1,0,0,3,5,1,1.22,0.89,3,4,2,0,0,0,0,1,3,4,0.63,1.5,1,5,0,1,1
Argentina - Torneo Federal,I. Chivilcoy,0,1,4,5,8,0.89,0.72,11,3,2,2,0,0,1,3,2,3,1.22,0.56,6,1,2,0,0,0,0,1,3,5,0.56,0.89,5,2,0,2,0
Argentina - Torneo Federal,J. Antoniana,0,1,5,6,4,1.19,0.94,6,5,5,0,0,0,1,4,3,0,1.75,0.5,5,2,1,0,0,0,0,1,3,4,0.63,1.38,1,3,4,0,0
Argentina - Torneo Federal,Juventud U. U.,0,1,0,11,5,0.82,0.76,6,9,2,0,0,0,1,0,6,1,1.13,0.63,4,3,1,0,0,0,0,0,5,4,0.56,0.89,2,6,1,0,0
Argentina - Torneo Federal,Kimberley,0,1,4,6,8,0.89,0.68,8,9,2,0,0,0,1,0,3,5,0.67,0.56,4,5,0,0,0,0,0,4,3,3,1.1,0.8,4,4,2,0,0
Argentina - Torneo Federal,Olimpo Bahia B.,1,0,3,11,4,1.11,0.84,7,8,4,0,0,1,0,3,5,1,1.5,1.1,2,5,3,0,0,0,0,0,6,3,0.67,0.56,5,3,1,0,0
Argentina - Torneo Federal,S. Belgrano,1,2,1,7,7,1.06,0.67,10,5,2,1,0,1,2,0,1,5,1.22,0.22,7,2,0,0,0,0,0,1,6,2,0.89,1.11,3,3,2,1,0
Argentina - Torneo Federal,S. Estudiantes,0,2,1,5,9,0.76,0.82,5,10,2,0,0,0,1,1,2,4,0.88,0.75,3,4,1,0,0,0,1,0,3,5,0.67,0.89,2,6,1,0,0
Argentina - Torneo Federal,S. Las Parejas,1,3,3,1,10,1.11,1.06,7,7,1,2,1,0,3,1,0,5,1.22,0.44,5,4,0,0,0,1,0,2,1,5,1.0,1.67,2,3,1,2,1
Argentina - Torneo Federal,SM Formosa,3,2,0,9,2,1.81,0.56,7,9,0,0,0,3,1,0,3,1,2.5,0.38,5,3,0,0,0,0,1,0,6,1,1.13,0.75,2,6,0,0,0
Argentina - Torneo Federal,SM Mendoza,2,1,1,8,5,1.24,1.12,8,4,2,2,1,1,1,1,4,2,1.44,0.67,5,3,0,1,0,1,0,0,4,3,1.0,1.63,3,1,2,1,1
Argentina - Torneo Federal,Santamarina,1,0,3,8,7,0.95,1.16,5,8,4,2,0,0,0,2,5,3,0.9,0.8,4,4,2,0,0,1,0,1,3,4,1.0,1.56,1,4,2,2,0
Argentina - Torneo Federal,Sarmiento DLB,1,1,3,8,3,1.31,0.69,7,7,2,0,0,1,0,2,4,1,1.5,0.38,5,3,0,0,0,0,1,1,4,2,1.13,1.0,2,4,2,0,0
Argentina - Torneo Federal,Sarmiento R.,0,1,2,6,8,0.76,1.29,7,4,2,3,1,0,1,2,3,2,1.25,1.13,3,3,0,2,0,0,0,0,3,6,0.33,1.44,4,1,2,1,1
Argentina - Torneo Federal,Sol de America,1,2,2,7,5,1.24,1.18,3,10,3,0,1,1,2,1,3,2,1.67,0.78,2,7,0,0,0,0,0,1,4,3,0.75,1.63,1,3,3,0,1
Argentina - Torneo Federal,Sol de Mayo,1,1,1,7,9,0.84,1.53,4,5,6,4,0,1,1,1,3,3,1.33,1.22,3,2,3,1,0,0,0,0,4,6,0.4,1.8,1,3,3,3,0
Argentina - Torneo Federal,Villa Mitre,0,2,4,8,5,1.16,0.53,11,6,2,0,0,0,1,3,4,1,1.44,0.33,7,1,1,0,0,0,1,1,4,4,0.9,0.7,4,5,1,0,0
Armenia - Premier League,Alashkert,0,1,6,9,14,0.8,1.73,7,7,8,5,3,0,1,4,5,5,1.07,1.67,4,3,5,2,1,0,0,2,4,9,0.53,1.8,3,4,3,3,2
Armenia - Premier League,Ararat Yerevan,0,3,10,7,10,1.2,1.97,5,9,6,5,5,0,1,6,4,4,1.27,1.67,2,5,5,2,1,0,2,4,3,6,1.13,2.27,3,4,1,3,4
Armenia - Premier League,Ararat-Armenia,6,11,5,5,3,2.5,0.93,14,6,8,2,0,4,6,1,3,1,2.8,0.87,7,4,3,1,0,2,5,4,2,2,2.2,1.0,7,2,5,1,0
Armenia - Premier League,BKMA,2,3,8,8,9,1.47,1.8,4,10,10,1,5,0,2,4,6,3,1.33,1.53,3,6,4,0,2,2,1,4,2,6,1.6,2.07,1,4,6,1,3
Armenia - Premier League,Gandzasar,0,1,2,9,18,0.53,2.43,3,6,10,5,6,0,0,1,5,9,0.47,2.73,1,2,4,4,4,0,1,1,4,9,0.6,2.13,2,4,6,1,2
Armenia - Premier League,Noah,11,5,8,5,1,3.07,0.67,15,11,3,1,0,7,2,5,1,0,3.53,0.33,10,5,0,0,0,4,3,3,4,1,2.6,1.0,5,6,3,1,0
Armenia - Premier League,Pyunik,4,6,6,9,5,1.97,1.23,10,9,6,4,1,3,2,1,7,2,2.0,1.4,5,3,4,2,1,1,4,5,2,3,1.93,1.07,5,6,2,2,0
Armenia - Premier League,Shirak,1,2,7,6,14,1.0,1.67,9,9,4,3,5,1,1,1,4,8,0.87,1.27,7,2,3,2,1,0,1,6,2,6,1.13,2.07,2,7,1,1,4
Armenia - Premier League,Urartu,5,6,6,10,3,2.13,1.03,12,8,7,3,0,2,4,3,3,3,2.2,1.07,6,4,3,2,0,3,2,3,7,0,2.07,1.0,6,4,4,1,0
Armenia - Premier League,Van,3,3,10,11,3,1.87,1.2,11,9,5,4,1,3,2,5,4,1,2.4,1.27,5,4,3,3,0,0,1,5,7,2,1.33,1.13,6,5,2,1,1
Armenia - Premier League,West Armenia,0,1,6,7,16,0.73,2.6,6,2,7,9,6,0,0,5,4,6,0.93,1.87,4,2,4,3,2,0,1,1,3,10,0.53,3.33,2,0,3,6,4
Australia - A-League,Adelaide Utd,4,5,7,8,2,2.04,2.12,4,6,6,5,5,1,3,5,4,0,2.08,2.08,1,3,5,3,1,3,2,2,4,2,2.0,2.15,3,3,1,2,4
Australia - A-League,Auckland,3,1,13,6,3,1.88,1.04,12,7,4,0,3,2,1,5,3,2,2.0,1.08,6,4,1,0,2,1,0,8,3,1,1.77,1.0,6,3,3,0,1
Australia - A-League,Brisbane Roar,2,1,6,9,8,1.23,1.96,1,12,4,6,3,0,0,3,6,4,0.92,2.0,1,6,1,3,2,2,1,3,3,4,1.54,1.92,0,6,3,3,1
Australia - A-League,Central Coast,0,3,6,8,9,1.12,1.96,3,10,5,3,5,0,1,3,4,5,1.0,2.08,2,3,3,2,3,0,2,3,4,4,1.23,1.85,1,7,2,1,2
Australia - A-League,Macarthur FC,4,4,4,10,4,1.92,1.73,3,7,12,2,2,2,1,1,7,2,1.69,1.92,1,3,6,2,1,2,3,3,3,2,2.15,1.54,2,4,6,0,1
Australia - A-League,Melbourne City,3,2,6,9,6,1.58,0.96,11,7,6,2,0,1,1,4,4,3,1.54,0.85,7,2,3,1,0,2,1,2,5,3,1.62,1.08,4,5,3,1,0
Australia - A-League,Melbourne V.,1,5,10,4,6,1.69,1.38,8,8,4,4,2,1,2,6,3,1,2.0,1.23,5,3,3,1,1,0,3,4,1,5,1.38,1.54,3,5,1,3,1
Australia - A-League,Newcastle Jets,2,3,7,10,4,1.65,1.69,5,8,7,4,2,1,2,3,4,3,1.69,1.69,2,5,4,1,1,1,1,4,6,1,1.62,1.69,3,3,3,3,1
Australia - A-League,Perth Glory,1,0,4,10,11,0.85,2.15,5,4,6,7,4,1,0,1,5,6,0.85,2.23,2,2,3,4,2,0,0,3,5,5,0.85,2.08,3,2,3,3,2
Australia - A-League,Sydney FC,3,9,5,4,5,2.04,1.77,5,6,9,3,3,3,6,2,2,0,2.77,1.92,2,3,4,2,2,0,3,3,2,5,1.31,1.62,3,3,5,1,1
Australia - A-League,WS Wanderers,5,4,10,6,1,2.23,1.54,5,9,7,3,2,4,1,5,2,1,2.38,1.77,1,5,4,2,1,1,3,5,4,0,2.08,1.31,4,4,3,1,1
Australia - A-League,Wellington,0,1,7,10,8,1.04,1.65,5,9,7,2,3,0,0,3,5,5,0.85,1.31,3,4,5,1,0,0,1,4,5,3,1.23,2.0,2,5,2,1,3
Australia - A-League,Western United,6,6,2,7,5,2.12,1.42,5,8,10,3,0,2,3,1,4,3,1.77,1.08,4,5,3,1,0,4,3,1,3,2,2.46,1.77,1,3,7,2,0
Austria - Bundesliga,Altach,0,0,0,0,0,,,0,0,0,0,0,0,0,0,0,0,,,0,0,0,0,0,0,0,0,0,0,,,0,0,0,0,0
Austria - Bundesliga,Austria Wien,0,0,0,0,0,,,0,0,0,0,0,0,0,0,0,0,,,0,0,0,0,0,0,0,0,0,0,,,0,0,0,0,0
Austria - Bundesliga,BW Linz,0,0,0,0,0,,,0,0,0,0,0,0,0,0,0,0,,,0,0,0,0,0,0,0,0,0,0,,,0,0,0,0,0
Austria - Bundesliga,Grazer AK,0,0,0,0,0,,,0,0,0,0,0,0,0,0,0,0,,,0,0,0,0,0,0,0,0,0,0,,,0,0,0,0,0
Austria - Bundesliga,Hartberg,0,0,0,0,0,,,0,0,0,0,0,0,0,0,0,0,,,0,0,0,0,0,0,0,0,0,0,,,0,0,0,0,0
Austria - Bundesliga,LASK Linz,0,0,0,0,0,,,0,0,0,0,0,0,0,0,0,0,,,0,0,0,0,0,0,0,0,0,0,,,0,0,0,0,0
Austria - Bundesliga,Rapid Wien,0,0,0,0,0,,,0,0,0,0,0,0,0,0,0,0,,,0,0,0,0,0,0,0,0,0,0,,,0,0,0,0,0
Austria - Bundesliga,Ried,0,0,0,0,0,,,0,0,0,0,0,0,0,0,0,0,,,0,0,0,0,0,0,0,0,0,0,,,0,0,0,0,0
Austria - Bundesliga,Salzburg,0,0,0,0,0,,,0,0,0,0,0,0,0,0,0,0,,,0,0,0,0,0,0,0,0,0,0,,,0,0,0,0,0
Austria - Bundesliga,Sturm Graz,0,0,0,0,0,,,0,0,0,0,0,0,0,0,0,0,,,0,0,0,0,0,0,0,0,0,0,,,0,0,0,0,0
Austria - Bundesliga,Tirol,0,0,0,0,0,,,0,0,0,0,0,0,0,0,0,0,,,0,0,0,0,0,0,0,0,0,0,,,0,0,0,0,0
Austria - Bundesliga,Wolfsberger AC,0,0,0,0,0,,,0,0,0,0,0,0,0,0,0,0,,,0,0,0,0,0,0,0,0,0,0,,,0,0,0,0,0
Austria - 2. Liga,A. Klagenfurt,0,0,0,0,0,,,0,0,0,0,0,0,0,0,0,0,,,0,0,0,0,0,0,0,0,0,0,,,0,0,0,0,0
Austria - 2. Liga,A. Lustenau,0,0,0,0,0,,,0,0,0,0,0,0,0,0,0,0,,,0,0,0,0,0,0,0,0,0,0,,,0,0,0,0,0
Austria - 2. Liga,Admira Wacker,0,0,0,0,0,,,0,0,0,0,0,0,0,0,0,0,,,0,0,0,0,0,0,0,0,0,0,,,0,0,0,0,0
Austria - 2. Liga,Amstetten,0,0,0,0,0,,,0,0,0,0,0,0,0,0,0,0,,,0,0,0,0,0,0,0,0,0,0,,,0,0,0,0,0
Austria - 2. Liga,Austria Salzbur,0,0,0,0,0,,,0,0,0,0,0,0,0,0,0,0,,,0,0,0,0,0,0,0,0,0,0,,,0,0,0,0,0
Austria - 2. Liga,Austria Wien B,0,0,0,0,0,,,0,0,0,0,0,0,0,0,0,0,,,0,0,0,0,0,0,0,0,0,0,,,0,0,0,0,0
Austria - 2. Liga,Bregenz,0,0,0,0,0,,,0,0,0,0,0,0,0,0,0,0,,,0,0,0,0,0,0,0,0,0,0,,,0,0,0,0,0
Austria - 2. Liga,First Vienna,0,0,0,0,0,,,0,0,0,0,0,0,0,0,0,0,,,0,0,0,0,0,0,0,0,0,0,,,0,0,0,0,0
Austria - 2. Liga,Floridsdorfer,0,0,0,0,0,,,0,0,0,0,0,0,0,0,0,0,,,0,0,0,0,0,0,0,0,0,0,,,0,0,0,0,0
Austria - 2. Liga,Kapfenberger,0,0,0,0,0,,,0,0,0,0,0,0,0,0,0,0,,,0,0,0,0,0,0,0,0,0,0,,,0,0,0,0,0
Austria - 2. Liga,Liefering,0,0,0,0,0,,,0,0,0,0,0,0,0,0,0,0,,,0,0,0,0,0,0,0,0,0,0,,,0,0,0,0,0
Austria - 2. Liga,Rapid Wien B,0,0,0,0,0,,,0,0,0,0,0,0,0,0,0,0,,,0,0,0,0,0,0,0,0,0,0,,,0,0,0,0,0
Austria - 2. Liga,St. Polten,0,0,0,0,0,,,0,0,0,0,0,0,0,0,0,0,,,0,0,0,0,0,0,0,0,0,0,,,0,0,0,0,0
Austria - 2. Liga,Stripfing,0,0,0,0,0,,,0,0,0,0,0,0,0,0,0,0,,,0,0,0,0,0,0,0,0,0,0,,,0,0,0,0,0
Austria - 2. Liga,Sturm Graz B,0,0,0,0,0,,,0,0,0,0,0,0,0,0,0,0,,,0,0,0,0,0,0,0,0,0,0,,,0,0,0,0,0
Austria - 2. Liga,WSPG Wels,0,0,0,0,0,,,0,0,0,0,0,0,0,0,0,0,,,0,0,0,0,0,0,0,0,0,0,,,0,0,0,0,0
Belgium - First Division A,Anderlecht,0,0,0,0,0,,,0,0,0,0,0,0,0,0,0,0,,,0,0,0,0,0,0,0,0,0,0,,,0,0,0,0,0
Belgium - First Division A,Antwerp,0,0,0,0,0,,,0,0,0,0,0,0,0,0,0,0,,,0,0,0,0,0,0,0,0,0,0,,,0,0,0,0,0
Belgium - First Division A,Cercle Brugge,0,0,0,0,0,,,0,0,0,0,0,0,0,0,0,0,,,0,0,0,0,0,0,0,0,0,0,,,0,0,0,0,0
Belgium - First Division A,Charleroi,0,0,0,0,0,,,0,0,0,0,0,0,0,0,0,0,,,0,0,0,0,0,0,0,0,0,0,,,0,0,0,0,0
Belgium - First Division A,Club Brugge,0,0,0,0,0,,,0,0,0,0,0,0,0,0,0,0,,,0,0,0,0,0,0,0,0,0,0,,,0,0,0,0,0
Belgium - First Division A,Dender,0,0,0,0,0,,,0,0,0,0,0,0,0,0,0,0,,,0,0,0,0,0,0,0,0,0,0,,,0,0,0,0,0
Belgium - First Division A,Gent,0,0,0,0,0,,,0,0,0,0,0,0,0,0,0,0,,,0,0,0,0,0,0,0,0,0,0,,,0,0,0,0,0
Belgium - First Division A,KRC Genk,0,0,0,0,0,,,0,0,0,0,0,0,0,0,0,0,,,0,0,0,0,0,0,0,0,0,0,,,0,0,0,0,0
Belgium - First Division A,KV Mechelen,0,0,0,0,0,,,0,0,0,0,0,0,0,0,0,0,,,0,0,0,0,0,0,0,0,0,0,,,0,0,0,0,0
Belgium - First Division A,La Louviere,0,0,0,0,0,,,0,0,0,0,0,0,0,0,0,0,,,0,0,0,0,0,0,0,0,0,0,,,0,0,0,0,0
Belgium - First Division A,OH Leuven,0,0,0,0,0,,,0,0,0,0,0,0,0,0,0,0,,,0,0,0,0,0,0,0,0,0,0,,,0,0,0,0,0
Belgium - First Division A,Royale Union SG,0,0,0,0,0,,,0,0,0,0,0,0,0,0,0,0,,,0,0,0,0,0,0,0,0,0,0,,,0,0,0,0,0
Belgium - First Division A,Sint-Truiden,0,0,0,0,0,,,0,0,0,0,0,0,0,0,0,0,,,0,0,0,0,0,0,0,0,0,0,,,0,0,0,0,0
Belgium - First Division A,Standard Liege,0,0,0,0,0,,,0,0,0,0,0,0,0,0,0,0,,,0,0,0,0,0,0,0,0,0,0,,,0,0,0,0,0
Belgium - First Division A,Westerlo,0,0,0,0,0,,,0,0,0,0,0,0,0,0,0,0,,,0,0,0,0,0,0,0,0,0,0,,,0,0,0,0,0
Belgium - First Division A,Zulte-Waregem,0,0,0,0,0,,,0,0,0,0,0,0,0,0,0,0,,,0,0,0,0,0,0,0,0,0,0,,,0,0,0,0,0
Belgium - First Division B,Anderlecht B,0,0,0,0,0,,,0,0,0,0,0,0,0,0,0,0,,,0,0,0,0,0,0,0,0,0,0,,,0,0,0,0,0
Belgium - First Division B,Beerschot,0,0,0,0,0,,,0,0,0,0,0,0,0,0,0,0,,,0,0,0,0,0,0,0,0,0,0,,,0,0,0,0,0
Belgium - First Division B,Beveren,0,0,0,0,0,,,0,0,0,0,0,0,0,0,0,0,,,0,0,0,0,0,0,0,0,0,0,,,0,0,0,0,0
Belgium - First Division B,Club Brugge B,0,0,0,0,0,,,0,0,0,0,0,0,0,0,0,0,,,0,0,0,0,0,0,0,0,0,0,,,0,0,0,0,0
Belgium - First Division B,Eupen,0,0,0,0,0,,,0,0,0,0,0,0,0,0,0,0,,,0,0,0,0,0,0,0,0,0,0,,,0,0,0,0,0
Belgium - First Division B,Francs Borains,0,0,0,0,0,,,0,0,0,0,0,0,0,0,0,0,,,0,0,0,0,0,0,0,0,0,0,,,0,0,0,0,0
Belgium - First Division B,Gent U21,0,0,0,0,0,,,0,0,0,0,0,0,0,0,0,0,,,0,0,0,0,0,0,0,0,0,0,,,0,0,0,0,0
Belgium - First Division B,KRC Genk B,0,0,0,0,0,,,0,0,0,0,0,0,0,0,0,0,,,0,0,0,0,0,0,0,0,0,0,,,0,0,0,0,0
Belgium - First Division B,Kortrijk,0,0,0,0,0,,,0,0,0,0,0,0,0,0,0,0,,,0,0,0,0,0,0,0,0,0,0,,,0,0,0,0,0
Belgium - First Division B,Lierse K.,0,0,0,0,0,,,0,0,0,0,0,0,0,0,0,0,,,0,0,0,0,0,0,0,0,0,0,,,0,0,0,0,0
Belgium - First Division B,Lokeren-Temse,0,0,0,0,0,,,0,0,0,0,0,0,0,0,0,0,,,0,0,0,0,0,0,0,0,0,0,,,0,0,0,0,0
Belgium - First Division B,Lommel SK,0,0,0,0,0,,,0,0,0,0,0,0,0,0,0,0,,,0,0,0,0,0,0,0,0,0,0,,,0,0,0,0,0
Belgium - First Division B,OC Charleroi,0,0,0,0,0,,,0,0,0,0,0,0,0,0,0,0,,,0,0,0,0,0,0,0,0,0,0,,,0,0,0,0,0
Belgium - First Division B,Patro Eisden,0,0,0,0,0,,,0,0,0,0,0,0,0,0,0,0,,,0,0,0,0,0,0,0,0,0,0,,,0,0,0,0,0
Belgium - First Division B,RFC Liege,0,0,0,0,0,,,0,0,0,0,0,0,0,0,0,0,,,0,0,0,0,0,0,0,0,0,0,,,0,0,0,0,0
Belgium - First Division B,RWDM,0,0,0,0,0,,,0,0,0,0,0,0,0,0,0,0,,,0,0,0,0,0,0,0,0,0,0,,,0,0,0,0,0
Belgium - First Division B,Seraing,0,0,0,0,0,,,0,0,0,0,0,0,0,0,0,0,,,0,0,0,0,0,0,0,0,0,0,,,0,0,0,0,0
Bolivia - Primera Div. - Apertura,ABB,0,1,4,6,3,1.21,1.57,4,4,2,3,1,0,0,3,2,2,1.14,1.14,2,3,1,1,0,0,1,1,4,1,1.29,2.0,2,1,1,2,1
Bolivia - Primera Div. - Apertura,Always Ready,6,0,5,3,1,3.27,1.33,4,5,5,0,1,4,0,2,1,0,3.86,1.0,2,3,2,0,0,2,0,3,2,1,2.75,1.63,2,2,3,0,1
Bolivia - Primera Div. - Apertura,Aurora,2,1,5,4,2,1.86,1.71,2,5,4,2,1,1,1,2,1,1,2.17,1.17,1,3,2,0,0,1,0,3,3,1,1.63,2.13,1,2,2,2,1
Bolivia - Primera Div. - Apertura,Blooming,2,3,5,3,1,2.21,1.5,1,8,4,0,1,2,3,2,0,1,2.75,1.0,1,6,1,0,0,0,0,3,3,0,1.5,2.17,0,2,3,0,1
Bolivia - Primera Div. - Apertura,Bolivar,4,2,2,6,0,2.43,1.14,4,5,4,1,0,3,1,1,3,0,2.75,1.25,2,3,2,1,0,1,1,1,3,0,2.0,1.0,2,2,2,0,0
Bolivia - Primera Div. - Apertura,GV San Jose,2,2,2,4,5,1.53,1.73,3,6,2,1,3,2,1,1,2,2,2.0,1.13,2,5,0,0,1,0,1,1,2,3,1.0,2.43,1,1,2,1,2
Bolivia - Primera Div. - Apertura,Guabira,2,1,2,9,1,1.73,2.13,2,5,2,2,4,2,1,1,3,0,2.57,1.57,2,2,1,1,1,0,0,1,6,1,1.0,2.63,0,3,1,1,3
Bolivia - Primera Div. - Apertura,I. Petrolero,1,1,2,6,4,1.29,2.21,2,4,2,2,4,1,0,1,3,2,1.43,1.57,1,3,2,0,1,0,1,1,3,2,1.14,2.86,1,1,0,2,3
Bolivia - Primera Div. - Apertura,Nacional Potosi,0,2,3,4,4,1.23,1.23,3,5,4,1,0,0,2,1,2,1,1.67,1.33,1,3,1,1,0,0,0,2,2,3,0.86,1.14,2,2,3,0,0
Bolivia - Primera Div. - Apertura,Oriente P.,0,3,3,6,2,1.5,2.07,2,5,3,1,3,0,2,2,2,1,1.71,1.29,2,2,2,1,0,0,1,1,4,1,1.29,2.86,0,3,1,0,3
Bolivia - Primera Div. - Apertura,Real Oruro,0,2,5,4,4,1.33,1.73,3,3,5,3,1,0,1,2,2,2,1.29,1.29,1,3,3,0,0,0,1,3,2,2,1.38,2.13,2,0,2,3,1
Bolivia - Primera Div. - Apertura,Real Tomayapo,0,2,2,5,6,1.0,1.6,3,6,3,2,1,0,2,2,2,2,1.5,1.38,1,4,2,1,0,0,0,0,3,4,0.43,1.86,2,2,1,1,1
Bolivia - Primera Div. - Apertura,SA Bulo Bulo,1,1,6,4,2,1.64,1.79,3,4,5,0,2,1,0,4,1,0,2.17,1.17,2,1,3,0,0,0,1,2,3,2,1.25,2.25,1,3,2,0,2
Bolivia - Primera Div. - Apertura,The Strongest,4,3,6,2,0,2.93,1.8,3,5,3,3,1,3,3,1,0,0,4.0,1.43,2,1,3,1,0,1,0,5,2,0,2.0,2.13,1,4,0,2,1
Bolivia - Primera Div. - Apertura,U. de Vinto,2,0,3,6,3,1.43,1.57,4,4,4,1,1,2,0,1,4,1,1.75,1.88,2,2,3,0,1,0,0,2,2,2,1.0,1.17,2,2,1,1,0
Bolivia - Primera Div. - Apertura,Wilstermann,0,0,2,7,6,0.73,2.2,1,5,5,2,2,0,0,1,3,4,0.63,1.88,1,4,2,0,1,0,0,1,4,2,0.86,2.57,0,1,3,2,1
Bolivia - Primera Div. - Clausura,Always Ready,3,3,6,11,7,1.6,1.23,10,10,5,4,1,2,1,3,7,2,1.67,1.2,7,3,2,2,1,1,2,3,4,5,1.53,1.27,3,7,3,2,0
Bolivia - Primera Div. - Clausura,Aurora,1,5,7,13,4,1.63,1.33,7,12,7,3,1,1,1,4,6,3,1.6,0.93,6,6,1,2,0,0,4,3,7,1,1.67,1.73,1,6,6,1,1
Bolivia - Primera Div. - Clausura,Blooming,2,2,4,14,8,1.2,1.43,10,12,2,1,5,2,2,2,7,2,1.67,1.0,5,8,1,0,1,0,0,2,7,6,0.73,1.87,5,4,1,1,4
Bolivia - Primera Div. - Clausura,Bolivar,10,5,5,6,4,2.53,0.83,14,9,5,2,0,7,2,2,0,4,2.73,0.6,9,4,1,1,0,3,3,3,6,0,2.33,1.07,5,5,4,1,0
Bolivia - Primera Div. - Clausura,Guabira,2,2,5,12,9,1.2,1.77,6,7,7,9,1,2,1,2,7,3,1.47,1.27,4,5,4,2,0,0,1,3,5,6,0.93,2.27,2,2,3,7,1
Bolivia - Primera Div. - Clausura,Gualberto V. SJ,6,4,8,5,7,2.07,1.33,10,7,8,3,2,6,2,5,0,2,3.0,0.73,8,3,4,0,0,0,2,3,5,5,1.13,1.93,2,4,4,3,2
Bolivia - Primera Div. - Clausura,I. Petrolero,1,6,11,3,9,1.6,1.93,4,8,10,6,2,1,6,4,0,4,2.07,1.87,2,5,5,2,1,0,0,7,3,5,1.13,2.0,2,3,5,4,1
Bolivia - Primera Div. - Clausura,Nacional Potosi,3,5,6,13,3,1.73,1.57,6,8,12,2,2,2,2,4,6,1,1.87,1.0,5,6,3,1,0,1,3,2,7,2,1.6,2.13,1,2,9,1,2
Bolivia - Primera Div. - Clausura,Oriente P.,3,2,8,9,8,1.47,1.93,5,7,10,3,5,3,0,4,4,4,1.67,1.4,3,6,4,1,1,0,2,4,5,4,1.27,2.47,2,1,6,2,4
Bolivia - Primera Div. - Clausura,Real Tomayapo,2,1,10,9,8,1.37,1.37,8,11,7,1,3,1,1,8,2,3,1.67,0.87,6,6,2,1,0,1,0,2,7,5,1.07,1.87,2,5,5,0,3
Bolivia - Primera Div. - Clausura,Royal Pari,0,4,5,8,13,1.0,1.53,7,8,10,3,2,0,2,4,3,6,1.13,1.27,3,6,5,1,0,0,2,1,5,7,0.87,1.8,4,2,5,2,2
Bolivia - Primera Div. - Clausura,SA Bulo Bulo,0,7,6,7,10,1.33,1.93,4,10,5,10,1,0,5,3,4,3,1.67,2.27,0,4,3,8,0,0,2,3,3,7,1.0,1.6,4,6,2,2,1
Bolivia - Primera Div. - Clausura,Santa Cruz,0,2,7,10,11,1.0,2.27,3,9,7,4,7,0,0,5,5,5,1.0,1.93,1,6,4,2,2,0,2,2,5,6,1.0,2.6,2,3,3,2,5
Bolivia - Primera Div. - Clausura,The Strongest,5,4,7,9,5,2.07,1.13,11,11,5,0,3,4,3,3,5,0,2.87,0.8,6,6,3,0,0,1,1,4,4,5,1.27,1.47,5,5,2,0,3
Bolivia - Primera Div. - Clausura,U. de Vinto,1,0,9,14,6,1.2,1.57,4,15,6,1,4,1,0,4,7,3,1.27,1.33,2,8,4,0,1,0,0,5,7,3,1.13,1.8,2,7,2,1,3
Bolivia - Primera Div. - Clausura,Wilstermann,0,3,9,8,10,1.17,1.0,13,7,7,3,0,0,3,6,3,3,1.6,0.93,7,3,4,1,0,0,0,3,5,7,0.73,1.07,6,4,3,2,0
Brazil - Serie A,Atletico MG,0,1,4,5,4,1.14,1.07,7,0,6,1,0,0,1,2,1,2,1.33,0.67,4,0,2,0,0,0,0,2,4,2,1.0,1.38,3,0,4,1,0
Brazil - Serie A,Bahia,0,1,4,6,3,1.21,0.93,4,8,1,1,0,0,0,3,4,0,1.43,0.71,2,5,0,0,0,0,1,1,2,3,1.0,1.14,2,3,1,1,0
Brazil - Serie A,Botafogo,1,1,4,2,6,1.21,0.5,9,3,2,0,0,1,1,3,0,1,2.17,0.67,4,0,2,0,0,0,0,1,2,5,0.5,0.38,5,3,0,0,0
Brazil - Serie A,Bragantino,0,0,5,8,2,1.2,1.0,6,4,4,1,0,0,0,2,5,1,1.13,1.13,4,0,3,1,0,0,0,3,3,1,1.29,0.86,2,4,1,0,0
Brazil - Serie A,Ceara,0,0,5,4,5,1.0,0.93,5,6,2,1,0,0,0,3,2,2,1.14,0.57,3,4,0,0,0,0,0,2,2,3,0.86,1.29,2,2,2,1,0
Brazil - Serie A,Corinthians,1,1,1,6,6,1.0,1.27,5,3,6,0,1,1,1,1,2,2,1.57,1.0,3,1,3,0,0,0,0,0,4,4,0.5,1.5,2,2,3,0,1
Brazil - Serie A,Cruzeiro,3,1,5,2,4,1.8,0.6,8,6,0,1,0,2,1,3,1,1,2.25,0.5,4,4,0,0,0,1,0,2,1,3,1.29,0.71,4,2,0,1,0
Brazil - Serie A,Flamengo,3,0,4,4,3,1.93,0.36,10,3,1,0,0,3,0,1,3,1,2.5,0.13,7,1,0,0,0,0,0,3,1,2,1.17,0.67,3,2,1,0,0
Brazil - Serie A,Fluminense,0,0,6,3,4,1.15,1.15,3,6,3,1,0,0,0,3,2,1,1.33,1.0,1,4,1,0,0,0,0,3,1,3,1.0,1.29,2,2,2,1,0
Brazil - Serie A,Fortaleza,1,0,2,4,7,0.93,1.43,5,3,3,2,1,1,0,2,2,3,1.38,1.13,3,2,2,1,0,0,0,0,2,4,0.33,1.83,2,1,1,1,1
Brazil - Serie A,Gremio,0,0,2,10,2,1.0,1.43,3,6,3,0,2,0,0,1,5,1,1.0,0.86,2,4,1,0,0,0,0,1,5,1,1.0,2.0,1,2,2,0,2
Brazil - Serie A,Internacional,0,2,1,6,5,1.0,1.29,4,6,2,0,2,0,2,0,3,2,1.29,0.71,3,3,1,0,0,0,0,1,3,3,0.71,1.86,1,3,1,0,2
Brazil - Serie A,Juventude,0,0,4,2,7,0.77,2.15,2,4,3,1,3,0,0,4,1,2,1.29,1.0,2,3,2,0,0,0,0,0,1,5,0.17,3.5,0,1,1,1,3
Brazil - Serie A,Mirassol,1,1,4,6,1,1.62,1.0,3,7,3,0,0,1,1,2,2,0,2.17,0.83,2,3,1,0,0,0,0,2,4,1,1.14,1.14,1,4,2,0,0
Brazil - Serie A,Palmeiras,0,1,4,5,3,1.23,0.85,5,5,3,0,0,0,1,1,2,3,1.0,0.86,3,2,2,0,0,0,0,3,3,0,1.5,0.83,2,3,1,0,0
Brazil - Serie A,Santos,0,1,2,5,6,0.86,1.21,4,4,5,1,0,0,0,2,2,2,1.0,0.83,3,1,2,0,0,0,1,0,3,4,0.75,1.5,1,3,3,1,0
Brazil - Serie A,Sao Paulo,0,0,5,4,6,0.93,1.2,4,5,5,1,0,0,0,3,2,3,1.0,1.0,3,3,1,1,0,0,0,2,2,3,0.86,1.43,1,2,4,0,0
Brazil - Serie A,Sport Recife,0,0,0,5,8,0.38,1.62,2,4,5,1,1,0,0,0,2,4,0.33,1.5,1,3,1,0,1,0,0,0,3,4,0.43,1.71,1,1,4,1,0
Brazil - Serie A,Vasco da Gama,0,3,1,4,6,1.07,1.36,2,6,5,1,0,0,2,1,1,4,1.13,1.0,2,4,2,0,0,0,1,0,3,2,1.0,1.83,0,2,3,1,0
Brazil - Serie A,Vitoria,0,0,3,5,7,0.73,1.0,4,7,4,0,0,0,0,2,3,2,1.0,0.86,2,4,1,0,0,0,0,1,2,5,0.5,1.13,2,3,3,0,0
Brazil - Serie B,Amazonas,0,1,3,7,6,0.94,1.35,4,8,1,3,1,0,1,2,3,3,1.11,0.67,4,4,1,0,0,0,0,1,4,3,0.75,2.13,0,4,0,3,1
Brazil - Serie B,America MG,0,2,3,5,7,1.0,1.24,3,9,3,2,0,0,1,2,4,2,1.22,1.0,2,5,2,0,0,0,1,1,1,5,0.75,1.5,1,4,1,2,0
Brazil - Serie B,Athletic Club,1,1,5,4,7,1.17,1.39,3,9,4,0,2,1,0,2,3,3,1.22,1.33,1,4,4,0,0,0,1,3,1,4,1.11,1.44,2,5,0,0,2
Brazil - Serie B,Athletico PR,0,0,7,8,3,1.22,1.33,3,9,4,1,1,0,0,3,4,3,1.0,1.1,2,7,0,0,1,0,0,4,4,0,1.5,1.63,1,2,4,1,0
Brazil - Serie B,Atletico GO,1,0,3,8,6,1.0,1.11,5,7,5,1,0,1,0,2,4,2,1.33,0.89,3,4,2,0,0,0,0,1,4,4,0.67,1.33,2,3,3,1,0
Brazil - Serie B,Avai,0,1,4,9,3,1.18,1.06,6,6,4,0,1,0,1,1,5,2,1.11,0.56,5,3,1,0,0,0,0,3,4,1,1.25,1.63,1,3,3,0,1
Brazil - Serie B,Botafogo SP,1,0,2,4,10,0.71,1.18,5,7,2,3,0,0,0,2,2,5,0.67,0.89,4,3,1,1,0,1,0,0,2,5,0.75,1.5,1,4,1,2,0
Brazil - Serie B,CRB,0,0,3,10,5,0.89,1.0,5,8,5,0,0,0,0,2,5,1,1.13,0.5,5,2,1,0,0,0,0,1,5,4,0.7,1.4,0,6,4,0,0
Brazil - Serie B,Chapecoense,1,0,5,7,4,1.24,0.94,4,10,3,0,0,1,0,3,4,0,1.75,1.0,2,4,2,0,0,0,0,2,3,4,0.78,0.89,2,6,1,0,0
Brazil - Serie B,Coritiba,0,0,6,7,5,1.06,0.67,11,5,1,0,1,0,0,5,2,1,1.5,0.75,6,1,0,0,1,0,0,1,5,4,0.7,0.6,5,4,1,0,0
Brazil - Serie B,Criciuma,1,1,1,11,3,1.18,1.0,5,7,5,0,0,1,1,1,4,2,1.44,1.0,3,3,3,0,0,0,0,0,7,1,0.88,1.0,2,4,2,0,0
Brazil - Serie B,Cuiaba,0,1,4,8,4,1.12,1.18,6,5,3,3,0,0,1,3,3,1,1.5,1.0,3,3,1,1,0,0,0,1,5,3,0.78,1.33,3,2,2,2,0
Brazil - Serie B,Ferroviaria,0,0,4,10,4,1.0,1.22,4,7,6,1,0,0,0,2,6,0,1.25,1.13,2,4,1,1,0,0,0,2,4,4,0.8,1.3,2,3,5,0,0
Brazil - Serie B,Goias,0,1,7,6,3,1.35,0.76,7,7,3,0,0,0,1,4,4,0,1.67,0.78,4,3,2,0,0,0,0,3,2,3,1.0,0.75,3,4,1,0,0
Brazil - Serie B,Novorizontino,0,3,3,7,4,1.29,0.71,7,8,2,0,0,0,3,2,4,0,1.89,0.78,3,5,1,0,0,0,0,1,3,4,0.63,0.63,4,3,1,0,0
Brazil - Serie B,Operario PR,0,3,3,6,6,1.17,1.11,6,4,8,0,0,0,2,2,4,1,1.56,0.78,5,1,3,0,0,0,1,1,2,5,0.78,1.44,1,3,5,0,0
Brazil - Serie B,Paysandu,1,0,3,5,8,0.94,1.12,5,6,5,1,0,0,0,2,3,3,0.88,1.13,2,3,3,0,0,1,0,1,2,5,1.0,1.11,3,3,2,1,0
Brazil - Serie B,Remo,0,0,5,9,3,1.12,0.88,5,9,3,0,0,0,0,3,4,2,1.11,0.44,5,4,0,0,0,0,0,2,5,1,1.13,1.38,0,5,3,0,0
Brazil - Serie B,Vila Nova,0,1,4,6,7,0.94,0.89,7,7,3,1,0,0,0,3,3,3,1.0,0.56,6,2,0,1,0,0,1,1,3,4,0.89,1.22,1,5,3,0,0
Brazil - Serie B,Volta Redonda,0,1,0,7,9,0.59,0.94,6,6,5,0,0,0,1,0,5,2,1.0,0.63,4,3,1,0,0,0,0,0,2,7,0.22,1.22,2,3,4,0,0
Brazil - Serie C,ABC,0,2,2,5,4,1.15,1.31,4,5,0,4,0,0,2,1,1,2,1.5,2.17,1,1,0,4,0,0,0,1,4,2,0.86,0.57,3,4,0,0,0
Brazil - Serie C,Anapolis,0,1,1,4,7,0.69,1.0,5,5,1,2,0,0,0,1,2,4,0.57,0.29,5,2,0,0,0,0,1,0,2,3,0.83,1.83,0,3,1,2,0
Brazil - Serie C,Botafogo PB,0,2,2,5,4,1.15,0.85,6,4,2,1,0,0,1,2,3,1,1.43,0.86,4,1,1,1,0,0,1,0,2,3,0.83,0.83,2,3,1,0,0
Brazil - Serie C,Brusque,1,0,1,6,5,0.92,0.92,7,2,3,0,1,0,0,0,4,3,0.57,0.71,4,1,2,0,0,1,0,1,2,2,1.33,1.17,3,1,1,0,1
Brazil - Serie C,CSA,0,2,3,3,5,1.15,0.92,4,7,1,1,0,0,1,3,2,1,1.57,1.14,2,3,1,1,0,0,1,0,1,4,0.67,0.67,2,4,0,0,0
Brazil - Serie C,Caxias,1,2,4,4,2,1.69,1.23,3,4,6,0,0,1,0,3,2,0,2.0,0.67,3,2,1,0,0,0,2,1,2,2,1.43,1.71,0,2,5,0,0
Brazil - Serie C,Confianca,1,1,2,3,6,1.08,1.46,2,5,4,2,0,1,1,1,2,1,1.83,1.5,0,3,3,0,0,0,0,1,1,5,0.43,1.43,2,2,1,2,0
Brazil - Serie C,Figueirense,0,0,4,7,2,1.15,1.08,5,4,2,2,0,0,0,2,3,1,1.17,0.83,3,2,0,1,0,0,0,2,4,1,1.14,1.29,2,2,2,1,0
Brazil - Serie C,Floresta,0,1,2,3,7,0.77,0.85,6,3,4,0,0,0,0,2,2,2,1.0,0.67,3,2,1,0,0,0,1,0,1,5,0.57,1.0,3,1,3,0,0
Brazil - Serie C,Guarani,0,0,4,2,7,0.77,0.92,5,5,2,1,0,0,0,3,1,3,1.0,0.86,3,3,0,1,0,0,0,1,1,4,0.5,1.0,2,2,2,0,0
Brazil - Serie C,Itabaiana,0,0,3,3,7,0.69,1.23,2,7,3,1,0,0,0,2,2,2,1.0,0.67,2,4,0,0,0,0,0,1,1,5,0.43,1.71,0,3,3,1,0
Brazil - Serie C,Ituano,0,2,1,4,6,0.92,1.0,5,4,3,1,0,0,1,1,1,4,0.86,0.86,3,3,0,1,0,0,1,0,3,2,1.0,1.17,2,1,3,0,0
Brazil - Serie C,Londrina,1,1,5,4,2,1.62,0.92,5,6,1,0,1,0,1,2,4,0,1.57,0.86,1,6,0,0,0,1,0,3,0,2,1.67,1.0,4,0,1,0,1
Brazil - Serie C,Maringa,0,3,1,6,3,1.31,1.46,2,5,4,2,0,0,1,0,3,2,1.0,1.17,1,3,2,0,0,0,2,1,3,1,1.57,1.71,1,2,2,2,0
Brazil - Serie C,Nautico,1,0,4,2,6,1.08,0.46,9,2,2,0,0,0,0,3,0,4,0.86,0.29,5,2,0,0,0,1,0,1,2,2,1.33,0.67,4,0,2,0,0
Brazil - Serie C,Ponte Preta,0,0,3,7,3,1.0,0.77,7,4,1,0,1,0,0,2,3,2,1.0,0.86,4,2,0,0,1,0,0,1,4,1,1.0,0.67,3,2,1,0,0
Brazil - Serie C,Retro,0,0,2,2,9,0.46,1.15,4,5,3,0,1,0,0,1,1,4,0.5,1.17,3,1,1,0,1,0,0,1,1,5,0.43,1.14,1,4,2,0,0
Brazil - Serie C,Sao Bernardo,0,1,2,7,3,1.08,0.62,7,5,0,1,0,0,1,1,3,1,1.33,0.67,4,1,0,1,0,0,0,1,4,2,0.86,0.57,3,4,0,0,0
Brazil - Serie C,Tombense,0,1,2,4,6,0.85,1.23,4,4,3,2,0,0,1,1,2,2,1.17,1.17,2,1,3,0,0,0,0,1,2,4,0.57,1.29,2,3,0,2,0
Brazil - Serie C,Ypiranga,0,2,0,6,5,0.92,1.08,7,1,3,1,1,0,1,0,3,3,0.86,1.14,4,0,2,0,1,0,1,0,3,2,1.0,1.0,3,1,1,1,0
Brazil - Serie D,ASA,3,1,3,3,3,1.85,0.62,8,2,3,0,0,2,0,2,2,0,2.33,1.0,3,0,3,0,0,1,1,1,1,3,1.43,0.29,5,2,0,0,0
Brazil - Serie D,Agua Santa,0,0,7,4,2,1.38,1.38,3,4,4,2,0,0,0,4,2,1,1.43,1.14,2,3,1,1,0,0,0,3,2,1,1.33,1.67,1,1,3,1,0
Brazil - Serie D,Aguia de Maraba,2,2,1,3,5,1.62,1.0,5,4,3,1,0,2,0,0,2,3,1.71,0.71,3,3,1,0,0,0,2,1,1,2,1.5,1.33,2,1,2,1,0
Brazil - Serie D,Altos,1,2,3,6,1,1.69,1.0,3,7,3,0,0,1,0,1,4,0,1.67,1.0,1,4,1,0,0,0,2,2,2,1,1.71,1.0,2,3,2,0,0
Brazil - Serie D,America RN,1,2,4,1,5,1.46,0.69,6,5,2,0,0,1,2,1,0,2,2.0,0.33,5,0,1,0,0,0,0,3,1,3,1.0,1.0,1,5,1,0,0
Brazil - Serie D,Aparecidense,2,4,2,3,2,2.31,0.85,7,3,1,2,0,2,1,2,0,1,3.0,0.5,3,3,0,0,0,0,3,0,3,1,1.71,1.14,4,0,1,2,0
Brazil - Serie D,Azuriz,0,0,1,4,8,0.46,1.08,4,7,0,1,1,0,0,0,3,3,0.5,0.83,3,2,0,1,0,0,0,1,1,5,0.43,1.29,1,5,0,0,1
Brazil - Serie D,Barcelona BA,1,0,1,3,8,0.69,1.46,4,4,2,1,2,1,0,1,1,3,1.17,0.83,2,3,1,0,0,0,0,0,2,5,0.29,2.0,2,1,1,1,2
Brazil - Serie D,Barra FC,0,3,3,5,2,1.54,0.69,7,4,1,1,0,0,2,1,3,0,1.83,0.33,4,2,0,0,0,0,1,2,2,2,1.29,1.0,3,2,1,1,0
Brazil - Serie D,Boavista,0,0,3,3,7,0.69,1.54,1,4,8,0,0,0,0,3,2,2,1.14,1.29,1,3,3,0,0,0,0,0,1,5,0.17,1.83,0,1,5,0,0
Brazil - Serie D,Brasil de P.,1,0,1,4,7,0.77,0.92,4,7,1,1,0,1,0,0,4,2,1.14,0.86,4,1,1,1,0,0,0,1,0,5,0.33,1.0,0,6,0,0,0
Brazil - Serie D,Capital,0,1,2,6,4,1.0,0.77,5,6,2,0,0,0,1,2,2,2,1.29,0.71,3,3,1,0,0,0,0,0,4,2,0.67,0.83,2,3,1,0,0
Brazil - Serie D,Cascavel,0,1,2,6,4,1.0,1.08,4,7,0,1,1,0,1,2,3,0,1.67,1.33,1,4,0,0,1,0,0,0,3,4,0.43,0.86,3,3,0,1,0
Brazil - Serie D,Ceilandia,0,1,7,4,1,1.62,1.08,5,3,4,1,0,0,1,2,3,0,1.67,0.67,4,1,0,1,0,0,0,5,1,1,1.57,1.43,1,2,4,0,0
Brazil - Serie D,Central SC,0,1,2,8,2,1.15,0.54,8,3,2,0,0,0,0,1,6,0,1.14,0.86,3,2,2,0,0,0,1,1,2,2,1.17,0.17,5,1,0,0,0
Brazil - Serie D,Cianorte,0,3,3,5,2,1.54,1.31,4,3,4,2,0,0,3,2,1,1,2.0,0.86,4,1,1,1,0,0,0,1,4,1,1.0,1.83,0,2,3,1,0
Brazil - Serie D,EC Sao Jose,0,4,2,4,3,1.54,0.77,5,7,0,1,0,0,2,0,3,1,1.5,0.83,3,2,0,1,0,0,2,2,1,2,1.57,0.71,2,5,0,0,0
Brazil - Serie D,Ferroviario,0,2,2,5,4,1.15,1.46,3,5,2,2,1,0,2,0,3,1,1.5,0.5,3,3,0,0,0,0,0,2,2,3,0.86,2.29,0,2,2,2,1
Brazil - Serie D,GAS,1,1,2,5,4,1.23,1.77,1,5,4,2,1,0,0,1,4,1,1.0,1.33,1,2,3,0,0,1,1,1,1,3,1.43,2.14,0,3,1,2,1
Brazil - Serie D,Goianesia,0,0,2,7,4,0.85,1.54,2,5,3,3,0,0,0,1,4,2,0.86,1.86,0,3,2,2,0,0,0,1,3,2,0.83,1.17,2,2,1,1,0
Brazil - Serie D,Goiania,0,1,3,3,6,0.92,1.62,2,5,2,4,0,0,0,2,2,3,0.86,1.57,1,3,1,2,0,0,1,1,1,3,1.0,1.67,1,2,1,2,0
Brazil - Serie D,Goiatuba EC,1,2,2,6,2,1.54,1.23,4,4,3,2,0,0,1,1,3,2,1.14,0.86,3,3,0,1,0,1,1,1,3,0,2.0,1.67,1,1,3,1,0
Brazil - Serie D,Guarany de Bage,0,1,1,4,7,0.69,1.0,5,5,1,2,0,0,1,1,2,2,1.17,1.17,2,2,1,1,0,0,0,0,2,5,0.29,0.86,3,3,0,1,0
Brazil - Serie D,Horizonte,1,0,4,2,6,1.08,1.15,4,6,1,1,1,1,0,3,1,2,1.57,0.71,3,3,1,0,0,0,0,1,1,4,0.5,1.67,1,3,0,1,1
Brazil - Serie D,Humaita,0,0,3,6,4,0.92,3.31,1,0,3,3,6,0,0,3,3,1,1.29,3.0,0,0,2,3,2,0,0,0,3,3,0.5,3.67,1,0,1,0,4
Brazil - Serie D,Iguatu,0,1,2,7,3,1.08,1.08,4,5,3,1,0,0,1,2,3,1,1.43,0.71,4,2,0,1,0,0,0,0,4,2,0.67,1.5,0,3,3,0,0
Brazil - Serie D,Imperatriz,1,1,2,3,6,1.08,1.0,5,5,1,2,0,1,0,1,2,2,1.33,0.33,4,2,0,0,0,0,1,1,1,4,0.86,1.57,1,3,1,2,0
Brazil - Serie D,Independencia,1,1,3,3,5,1.23,1.38,2,7,2,1,1,1,0,1,1,3,1.17,1.0,2,2,2,0,0,0,1,2,2,2,1.29,1.71,0,5,0,1,1
Brazil - Serie D,Inter Limeira,1,3,1,5,3,1.62,0.46,8,4,1,0,0,1,1,1,3,0,2.17,0.5,3,3,0,0,0,0,2,0,2,3,1.14,0.43,5,1,1,0,0
Brazil - Serie D,Itabirito,0,0,1,8,4,0.77,1.54,3,5,1,3,1,0,0,1,3,2,0.83,1.33,1,3,1,1,0,0,0,0,5,2,0.71,1.71,2,2,0,2,1
Brazil - Serie D,Jequie,1,1,2,4,5,1.15,1.15,6,2,3,1,1,0,1,1,2,3,1.0,0.57,5,1,0,1,0,1,0,1,2,2,1.33,1.83,1,1,3,0,1
Brazil - Serie D,Joinville,0,0,2,6,5,0.77,0.69,5,7,1,0,0,0,0,2,4,1,1.14,0.71,3,3,1,0,0,0,0,0,2,4,0.33,0.67,2,4,0,0,0
Brazil - Serie D,Juazeirense,0,1,2,5,5,0.92,0.92,6,4,1,2,0,0,0,2,3,2,1.0,0.86,3,3,0,1,0,0,1,0,2,3,0.83,1.0,3,1,1,1,0
Brazil - Serie D,Lagarto,1,1,5,3,3,1.54,1.15,4,5,2,2,0,1,1,3,0,2,1.86,0.86,3,3,0,1,0,0,0,2,3,1,1.17,1.5,1,2,2,1,0
Brazil - Serie D,Luverdense,0,1,2,6,4,1.0,0.92,6,4,2,0,1,0,1,2,2,1,1.5,0.67,3,2,1,0,0,0,0,0,4,3,0.57,1.14,3,2,1,0,1
Brazil - Serie D,Manauara,1,3,4,4,1,2.0,0.69,7,3,3,0,0,1,2,2,1,1,2.29,0.43,5,1,1,0,0,0,1,2,3,0,1.67,1.0,2,2,2,0,0
Brazil - Serie D,Manaus,1,1,4,5,2,1.54,1.31,2,7,2,2,0,1,1,1,3,0,2.0,1.17,2,2,1,1,0,0,0,3,2,2,1.14,1.43,0,5,1,1,0
Brazil - Serie D,Maracana,0,0,4,3,6,0.85,1.69,3,2,4,4,0,0,0,2,2,2,1.0,1.5,2,1,1,2,0,0,0,2,1,4,0.71,1.86,1,1,3,2,0
Brazil - Serie D,Maranhao,0,2,3,5,3,1.31,0.92,4,7,1,1,0,0,2,2,3,0,1.86,0.86,3,3,0,1,0,0,0,1,2,3,0.67,1.0,1,4,1,0,0
Brazil - Serie D,Marcilio Dias,0,2,1,8,2,1.23,1.08,5,4,2,2,0,0,1,0,5,1,1.14,0.43,5,1,1,0,0,0,1,1,3,1,1.33,1.83,0,3,1,2,0
Brazil - Serie D,Marica,0,1,2,7,3,1.08,0.85,4,7,2,0,0,0,0,2,3,2,1.0,0.57,3,4,0,0,0,0,1,0,4,1,1.17,1.17,1,3,2,0,0
Brazil - Serie D,Mixto,1,3,1,4,4,1.46,1.0,5,4,3,1,0,1,2,0,2,2,1.71,1.0,3,2,1,1,0,0,1,1,2,2,1.17,1.0,2,2,2,0,0
Brazil - Serie D,Monte Azul,0,1,1,5,5,0.83,1.25,0,9,3,0,0,0,1,1,1,3,1.0,1.17,0,5,1,0,0,0,0,0,4,2,0.67,1.33,0,4,2,0,0
Brazil - Serie D,Nova Iguacu,0,0,2,8,3,0.92,1.15,2,8,2,1,0,0,0,2,3,1,1.17,1.33,1,3,1,1,0,0,0,0,5,2,0.71,1.0,1,5,1,0,0
Brazil - Serie D,Operario MS,0,1,1,6,4,0.92,1.58,1,7,2,1,1,0,0,1,3,2,0.83,0.83,1,5,0,0,0,0,1,0,3,2,1.0,2.33,0,2,2,1,1
Brazil - Serie D,Parnahyba,0,1,4,3,5,1.08,1.46,4,2,5,1,1,0,1,3,1,2,1.43,1.14,3,0,4,0,0,0,0,1,2,3,0.67,1.83,1,2,1,1,1
Brazil - Serie D,Penedense,0,0,1,2,10,0.31,1.31,3,7,1,0,2,0,0,1,1,5,0.43,1.14,2,4,0,0,1,0,0,0,1,5,0.17,1.5,1,3,1,0,1
Brazil - Serie D,Porto Velho,0,2,1,1,9,0.69,2.08,2,4,3,2,2,0,1,1,0,4,0.83,1.0,2,2,2,0,0,0,1,0,1,5,0.57,3.0,0,2,1,2,2
Brazil - Serie D,Porto Vitória,0,1,2,6,4,1.0,0.92,6,3,3,1,0,0,1,2,2,2,1.29,0.71,4,2,0,1,0,0,0,0,4,2,0.67,1.17,2,1,3,0,0
Brazil - Serie D,Portuguesa,0,1,6,4,2,1.46,1.0,3,7,3,0,0,0,0,5,1,0,1.83,0.83,1,5,0,0,0,0,1,1,3,2,1.14,1.14,2,2,3,0,0
Brazil - Serie D,Pouso Alegre,0,1,2,6,4,1.0,1.23,4,4,3,2,0,0,0,2,4,0,1.33,0.33,4,2,0,0,0,0,1,0,2,4,0.71,2.0,0,2,3,2,0
Brazil - Serie D,Rio Branco ES,0,2,4,2,5,1.23,0.69,7,3,3,0,0,0,2,2,0,2,1.67,0.5,4,1,1,0,0,0,0,2,2,3,0.86,0.86,3,2,2,0,0
Brazil - Serie D,Sampaio Correa,0,1,5,3,4,1.23,0.77,6,4,3,0,0,0,1,3,2,0,1.83,0.5,4,1,1,0,0,0,0,2,1,4,0.71,1.0,2,3,2,0,0
Brazil - Serie D,Santa C. Natal,0,0,2,7,4,0.85,1.46,4,3,3,2,1,0,0,0,5,2,0.71,0.86,4,0,3,0,0,0,0,2,2,2,1.0,2.17,0,3,0,2,1
Brazil - Serie D,Santa Cruz,1,1,3,4,4,1.31,0.77,6,5,1,1,0,1,1,2,1,1,2.0,0.67,2,4,0,0,0,0,0,1,3,3,0.71,0.86,4,1,1,1,0
Brazil - Serie D,Sao Luiz,0,1,0,7,5,0.77,1.54,4,1,5,3,0,0,1,0,4,2,1.0,1.0,3,1,3,0,0,0,0,0,3,3,0.5,2.17,1,0,2,3,0
Brazil - Serie D,Sergipe,1,1,2,4,5,1.15,0.77,7,2,4,0,0,1,0,1,2,2,1.33,0.83,3,1,2,0,0,0,1,1,2,3,1.0,0.71,4,1,2,0,0
Brazil - Serie D,Sousa,1,1,0,3,8,0.77,0.92,4,6,3,0,0,1,1,0,1,3,1.33,0.5,3,3,0,0,0,0,0,0,2,5,0.29,1.29,1,3,3,0,0
Brazil - Serie D,Tocantinopolis,0,1,1,6,5,0.85,1.23,4,4,4,0,1,0,0,1,4,2,0.86,0.86,3,2,2,0,0,0,1,0,2,3,0.83,1.67,1,2,2,0,1
Brazil - Serie D,Trem,2,0,5,4,2,1.77,1.77,1,5,4,2,1,1,0,2,3,1,1.71,1.71,0,4,1,2,0,1,0,3,1,1,1.83,1.83,1,1,3,0,1
Brazil - Serie D,Treze,0,0,0,7,6,0.54,1.31,4,4,3,1,1,0,0,0,4,3,0.57,1.43,2,1,3,1,0,0,0,0,3,3,0.5,1.17,2,3,0,0,1
Brazil - Serie D,Tuna Luso,1,4,2,2,4,1.69,0.77,8,1,3,1,0,1,3,2,0,0,2.83,0.5,4,1,1,0,0,0,1,0,2,4,0.71,1.0,4,0,2,1,0
Brazil - Serie D,Uberlandia,1,1,4,5,2,1.54,1.38,2,7,1,3,0,1,0,3,2,1,1.71,1.29,2,3,0,2,0,0,1,1,3,1,1.33,1.5,0,4,1,1,0
Brazil - Serie D,Uniao C.,0,1,2,6,4,1.0,1.23,5,4,2,0,2,0,1,1,3,1,1.33,0.83,4,1,0,0,1,0,0,1,3,3,0.71,1.57,1,3,2,0,1
Bulgaria - Parva Liga,Arda,0,0,0,0,1,0.0,1.0,0,1,0,0,0,0,0,0,0,0,,,0,0,0,0,0,0,0,0,0,1,0.0,1.0,0,1,0,0,0
Bulgaria - Parva Liga,Beroe,0,0,0,0,1,0.0,0.0,1,0,0,0,0,0,0,0,0,0,,,0,0,0,0,0,0,0,0,0,1,0.0,0.0,1,0,0,0,0
Bulgaria - Parva Liga,Botev Plovdiv,0,0,0,1,0,1.0,1.0,0,1,0,0,0,0,0,0,1,0,1.0,1.0,0,1,0,0,0,0,0,0,0,0,,,0,0,0,0,0
Bulgaria - Parva Liga,Botev Vratsa,0,0,1,0,0,2.0,2.0,0,0,1,0,0,0,0,0,0,0,,,0,0,0,0,0,0,0,1,0,0,2.0,2.0,0,0,1,0,0
Bulgaria - Parva Liga,CSKA 1948 Sofia,0,0,0,1,0,1.0,0.0,1,0,0,0,0,0,0,0,1,0,1.0,0.0,1,0,0,0,0,0,0,0,0,0,,,0,0,0,0,0
Bulgaria - Parva Liga,CSKA Sofia,0,0,0,1,0,1.0,1.0,0,1,0,0,0,0,0,0,0,0,,,0,0,0,0,0,0,0,0,1,0,1.0,1.0,0,1,0,0,0
Bulgaria - Parva Liga,Cherno More,0,0,0,1,0,1.0,1.0,0,1,0,0,0,0,0,0,0,0,,,0,0,0,0,0,0,0,0,1,0,1.0,1.0,0,1,0,0,0
Bulgaria - Parva Liga,Dobrudzha,0,0,0,0,1,0.0,1.0,0,1,0,0,0,0,0,0,0,0,,,0,0,0,0,0,0,0,0,0,1,0.0,1.0,0,1,0,0,0
Bulgaria - Parva Liga,Levski Sofia,1,0,0,0,0,5.0,0.0,1,0,0,0,0,1,0,0,0,0,5.0,0.0,1,0,0,0,0,0,0,0,0,0,,,0,0,0,0,0
Bulgaria - Parva Liga,Lok. Plovdiv,0,0,0,1,0,1.0,0.0,1,0,0,0,0,0,0,0,1,0,1.0,0.0,1,0,0,0,0,0,0,0,0,0,,,0,0,0,0,0
Bulgaria - Parva Liga,Lokomotiv Sofia,0,0,0,1,0,1.0,1.0,0,1,0,0,0,0,0,0,1,0,1.0,1.0,0,1,0,0,0,0,0,0,0,0,,,0,0,0,0,0
Bulgaria - Parva Liga,Ludogorets,1,0,0,0,0,5.0,0.0,1,0,0,0,0,1,0,0,0,0,5.0,0.0,1,0,0,0,0,0,0,0,0,0,,,0,0,0,0,0
Bulgaria - Parva Liga,Montana,0,0,0,0,1,0.0,5.0,0,0,0,0,1,0,0,0,0,0,,,0,0,0,0,0,0,0,0,0,1,0.0,5.0,0,0,0,0,1
Bulgaria - Parva Liga,Septemvri Sofia,0,0,0,0,1,0.0,5.0,0,0,0,0,1,0,0,0,0,0,,,0,0,0,0,0,0,0,0,0,1,0.0,5.0,0,0,0,0,1
Bulgaria - Parva Liga,Slavia Sofia,0,0,1,0,0,2.0,2.0,0,0,1,0,0,0,0,1,0,0,2.0,2.0,0,0,1,0,0,0,0,0,0,0,,,0,0,0,0,0
Bulgaria - Parva Liga,Spartak Varna,0,0,0,0,1,0.0,0.0,1,0,0,0,0,0,0,0,0,1,0.0,0.0,1,0,0,0,0,0,0,0,0,0,,,0,0,0,0,0
Canada - Premier League,A. Ottawa,2,4,5,2,2,2.2,1.07,5,4,6,0,0,1,3,2,1,0,2.71,1.14,2,2,3,0,0,1,1,3,1,2,1.75,1.0,3,2,3,0,0
Canada - Premier League,Cavalry,2,1,3,4,3,1.62,0.92,4,7,1,1,0,2,0,1,2,1,2.0,1.17,2,2,1,1,0,0,1,2,2,2,1.29,0.71,2,5,0,0,0
Canada - Premier League,Forge,1,0,8,5,1,1.73,0.73,7,5,3,0,0,0,0,5,3,0,1.63,1.0,2,4,2,0,0,1,0,3,2,1,1.86,0.43,5,1,1,0,0
Canada - Premier League,HFX Wanderers,0,2,5,4,4,1.33,1.2,5,4,4,2,0,0,2,1,2,2,1.43,0.86,3,3,0,1,0,0,0,4,2,2,1.25,1.5,2,1,4,1,0
Canada - Premier League,Pacific,1,1,2,4,6,1.07,1.93,2,4,3,3,2,1,1,2,1,3,1.5,1.75,1,3,2,1,1,0,0,0,3,3,0.5,2.17,1,1,1,2,1
Canada - Premier League,Valour,0,1,3,4,6,0.93,2.43,1,4,2,4,3,0,1,1,2,3,1.0,1.86,1,3,1,1,1,0,0,2,2,3,0.86,3.0,0,1,1,3,2
Canada - Premier League,Vancouver FC,1,1,1,5,7,0.93,2.0,1,5,5,1,3,0,0,1,2,4,0.57,1.86,1,1,4,0,1,1,1,0,3,3,1.25,2.13,0,4,1,1,2
Canada - Premier League,York Utd,1,2,5,6,1,1.73,1.33,5,1,8,1,0,1,1,2,3,1,1.75,1.0,4,0,4,0,0,0,1,3,3,0,1.71,1.71,1,1,4,1,0
China - Super League,Beijing Guoan,3,1,8,5,0,2.24,1.06,6,7,2,1,1,1,1,3,4,0,2.11,0.89,3,5,0,1,0,2,0,5,1,0,2.38,1.25,3,2,2,0,1
China - Super League,Changchun Yatai,0,1,1,10,5,0.88,1.88,2,3,8,3,1,0,0,0,7,2,0.78,1.44,2,2,4,1,0,0,1,1,3,3,1.0,2.38,0,1,4,2,1
China - Super League,Chengdu,2,2,5,8,0,1.94,0.88,7,6,3,1,0,1,0,2,5,0,1.75,0.63,4,3,1,0,0,1,2,3,3,0,2.11,1.11,3,3,2,1,0
China - Super League,Dalian Yingbo,0,1,3,8,5,1.0,1.41,5,4,5,2,1,0,1,2,4,2,1.22,0.89,5,1,2,1,0,0,0,1,4,3,0.75,2.0,0,3,3,1,1
China - Super League,Henan SL,0,4,3,7,3,1.47,1.76,2,5,6,3,1,0,3,2,4,0,1.89,2.33,0,2,3,3,1,0,1,1,3,3,1.0,1.13,2,3,3,0,0
China - Super League,Meizhou Hakka,0,3,3,7,4,1.29,2.12,1,5,5,3,3,0,3,1,3,2,1.56,2.44,1,2,1,2,3,0,0,2,4,2,1.0,1.75,0,3,4,1,0
China - Super League,Qingdao Hainiu,0,1,2,6,8,0.76,1.71,1,9,2,4,1,0,1,1,3,3,1.0,1.25,1,5,1,1,0,0,0,1,3,5,0.56,2.11,0,4,1,3,1
China - Super League,Qingdao West C.,0,3,4,5,5,1.29,1.47,5,5,4,1,2,0,2,3,2,2,1.56,1.22,5,1,1,1,1,0,1,1,3,3,1.0,1.75,0,4,3,0,1
China - Super League,S. Shenhua,1,8,4,3,1,2.29,1.0,5,8,3,1,0,1,4,3,0,0,2.75,1.0,3,2,3,0,0,0,4,1,3,1,1.89,1.0,2,6,0,1,0
China - Super League,Shandong T.,5,1,3,3,5,1.94,1.71,2,8,3,3,1,3,1,0,1,3,2.0,1.13,2,4,1,1,0,2,0,3,2,2,1.89,2.22,0,4,2,2,1
China - Super League,Shanghai Port,1,7,5,4,0,2.29,1.24,3,9,3,2,0,0,3,2,4,0,1.89,1.11,2,5,1,1,0,1,4,3,0,0,2.75,1.38,1,4,2,1,0
China - Super League,Shenzhen P. C.,1,3,0,8,5,1.24,2.06,4,3,2,5,3,1,3,0,5,0,2.0,1.56,2,3,2,1,1,0,0,0,3,5,0.38,2.63,2,0,0,4,2
China - Super League,Tianjin T.,1,0,8,5,3,1.47,1.47,3,7,4,2,1,0,0,4,3,1,1.38,1.25,3,2,2,0,1,1,0,4,2,2,1.56,1.67,0,5,2,2,0
China - Super League,Wuhan Three T.,1,1,6,4,5,1.35,1.82,1,7,5,2,2,1,1,4,1,2,1.78,1.89,1,3,3,0,2,0,0,2,3,3,0.88,1.75,0,4,2,2,0
China - Super League,Yunnan Yukun,1,1,4,8,3,1.35,1.59,5,3,3,6,0,0,1,3,2,1,1.57,1.29,2,2,2,1,0,1,0,1,6,2,1.2,1.8,3,1,1,5,0
China - Super League,Zhejiang,2,3,6,3,3,1.88,1.53,3,5,7,1,1,1,2,4,1,0,2.38,1.38,1,3,4,0,0,1,1,2,2,3,1.44,1.67,2,2,3,1,1
China - League One,Chongqing T.,4,1,4,6,1,2.13,1.19,5,7,1,2,1,1,0,3,3,1,1.63,0.63,3,5,0,0,0,3,1,1,3,0,2.63,1.75,2,2,1,2,1
China - League One,Dalian Kuncheng,0,2,5,5,4,1.31,1.31,3,7,4,2,0,0,2,2,2,2,1.5,0.88,2,5,1,0,0,0,0,3,3,2,1.13,1.75,1,2,3,2,0
China - League One,Dingnan,0,2,4,7,3,1.31,1.38,3,7,3,3,0,0,2,4,2,1,1.78,1.22,2,4,2,1,0,0,0,0,5,2,0.71,1.57,1,3,1,2,0
China - League One,Foshan Nanshi,0,0,4,7,6,0.88,1.41,3,5,8,1,0,0,0,3,3,3,1.0,1.44,1,4,3,1,0,0,0,1,4,3,0.75,1.38,2,1,5,0,0
China - League One,Guangdong GZP,2,2,5,4,3,1.75,1.25,6,3,6,0,1,1,1,3,1,2,1.75,1.38,4,0,3,0,1,1,1,2,3,1,1.75,1.13,2,3,3,0,0
China - League One,Guangxi Pingguo,0,0,1,7,9,0.53,1.59,4,4,5,3,1,0,0,0,4,4,0.5,1.75,2,2,1,2,1,0,0,1,3,5,0.56,1.44,2,2,4,1,0
China - League One,Liaoning Tieren,2,4,6,5,0,2.35,0.94,6,7,3,1,0,2,1,3,3,0,2.56,0.78,3,5,1,0,0,0,3,3,2,0,2.13,1.13,3,2,2,1,0
China - League One,Nanjing City,0,2,4,8,3,1.29,1.47,3,8,3,1,2,0,0,4,3,2,1.22,1.22,2,5,1,0,1,0,2,0,5,1,1.38,1.75,1,3,2,1,1
China - League One,Nantong Zhiyun,1,0,5,6,5,1.24,1.24,6,5,3,2,1,1,0,3,2,2,1.63,1.25,3,2,2,0,1,0,0,2,4,3,0.89,1.22,3,3,1,2,0
China - League One,Qingdao RL,0,1,1,5,10,0.59,1.29,3,9,3,1,1,0,1,0,3,4,0.75,1.63,1,4,1,1,1,0,0,1,2,6,0.44,1.0,2,5,2,0,0
China - League One,S. Gongfu,1,2,6,5,3,1.59,1.24,5,6,4,1,1,0,2,3,3,1,1.67,1.11,2,4,3,0,0,1,0,3,2,2,1.5,1.38,3,2,1,1,1
China - League One,Shaanxi Union,1,3,1,6,5,1.31,1.5,2,5,8,1,0,0,3,1,2,1,1.86,1.57,0,4,2,1,0,1,0,0,4,4,0.89,1.44,2,1,6,0,0
China - League One,Shanghai Jiadin,0,2,5,2,8,1.06,1.41,4,7,3,1,2,0,2,4,0,3,1.56,1.11,3,4,1,0,1,0,0,1,2,5,0.5,1.75,1,3,2,1,1
China - League One,Shenzhen J.,2,0,5,6,4,1.41,1.94,4,4,4,3,2,2,0,3,2,1,2.0,1.38,2,3,1,2,0,0,0,2,4,3,0.89,2.44,2,1,3,1,2
China - League One,Suzhou Dongwu,0,1,4,6,5,1.06,0.88,8,4,2,2,0,0,0,2,1,4,0.71,0.29,5,2,0,0,0,0,1,2,5,1,1.33,1.33,3,2,2,2,0
China - League One,Yanbian Longdin,0,2,4,7,4,1.24,0.94,8,4,4,0,1,0,2,3,4,0,1.78,0.33,7,1,1,0,0,0,0,1,3,4,0.63,1.63,1,3,3,0,1
China - League Two,Beijing IT,0,1,5,6,8,0.95,1.4,4,8,4,4,0,0,0,5,1,4,1.1,1.2,3,4,1,2,0,0,1,0,5,4,0.8,1.6,1,4,3,2,0
China - League Two,C. Rongcheng B,3,2,4,8,3,1.75,0.8,9,7,3,1,0,1,0,4,3,2,1.6,0.9,5,2,2,1,0,2,2,0,5,1,1.9,0.7,4,5,1,0,0
China - League Two,Changchun Xidu,0,1,4,8,7,0.95,0.55,12,7,0,0,1,0,0,3,5,2,1.1,0.4,6,4,0,0,0,0,1,1,3,5,0.8,0.7,6,3,0,0,1
China - League Two,G. Dandelion,1,4,2,10,3,1.5,0.85,9,6,4,1,0,1,2,2,4,1,1.8,0.9,5,2,2,1,0,0,2,0,6,2,1.2,0.8,4,4,2,0,0
China - League Two,G. Zhucheng,1,0,10,6,3,1.55,1.2,7,6,4,2,1,1,0,4,4,1,1.7,0.6,5,4,1,0,0,0,0,6,2,2,1.4,1.8,2,2,3,2,1
China - League Two,Ganzhou Ruishi,0,0,5,7,8,0.85,1.35,5,6,8,0,1,0,0,4,4,2,1.2,1.0,3,4,3,0,0,0,0,1,3,6,0.5,1.7,2,2,5,0,1
China - League Two,Guangdong M.,0,1,4,6,9,0.85,1.5,4,6,6,4,0,0,1,3,4,2,1.3,1.8,1,3,3,3,0,0,0,1,2,7,0.4,1.2,3,3,3,1,0
China - League Two,Guangxi H.,2,3,9,4,2,2.15,0.45,13,5,2,0,0,1,1,4,3,1,2.1,0.6,6,2,2,0,0,1,2,5,1,1,2.2,0.3,7,3,0,0,0
China - League Two,Guangxi Lanhang,0,0,2,5,13,0.45,2.1,2,5,8,1,4,0,0,1,0,9,0.2,2.4,1,2,3,1,3,0,0,1,5,4,0.7,1.8,1,3,5,0,1
China - League Two,Hangzhou Linpin,0,1,6,8,5,1.15,1.25,5,9,2,4,0,0,0,4,4,2,1.2,1.1,4,3,1,2,0,0,1,2,4,3,1.1,1.4,1,6,1,2,0
China - League Two,Hubei Istar,1,2,3,6,8,1.1,1.8,5,2,8,3,2,0,1,1,5,3,1.0,1.8,3,1,2,3,1,1,1,2,1,5,1.2,1.8,2,1,6,0,1
China - League Two,Jiangxi Lushan,0,1,5,10,4,1.15,0.9,11,4,3,0,2,0,0,3,5,2,1.1,1.0,5,2,2,0,1,0,1,2,5,2,1.2,0.8,6,2,1,0,1
China - League Two,Kunming City,0,0,3,8,9,0.7,1.35,6,6,7,0,1,0,0,0,6,4,0.6,0.8,4,4,2,0,0,0,0,3,2,5,0.8,1.9,2,2,5,0,1
China - League Two,L. Longyuan,0,3,2,6,9,0.95,1.45,3,6,10,1,0,0,1,1,5,3,1.0,1.4,1,4,5,0,0,0,2,1,1,6,0.9,1.5,2,2,5,1,0
China - League Two,Nantong Haimen,3,3,4,6,4,1.9,1.15,8,6,4,0,2,3,2,2,2,1,2.7,1.0,4,4,1,0,1,0,1,2,4,3,1.1,1.3,4,2,3,0,1
China - League Two,Quanzhou Yassin,0,0,2,6,11,0.53,1.42,3,8,6,1,1,0,0,2,1,6,0.56,1.33,2,4,2,0,1,0,0,0,5,5,0.5,1.5,1,4,4,1,0
China - League Two,Shandong T. B,3,1,5,7,4,1.6,1.0,8,6,5,0,1,2,1,3,3,1,2.0,0.9,4,3,3,0,0,1,0,2,4,3,1.2,1.1,4,3,2,0,1
China - League Two,Shanghai Port B,1,0,5,7,7,1.1,1.0,6,9,4,1,0,1,0,3,3,3,1.4,1.1,4,2,3,1,0,0,0,2,4,4,0.8,0.9,2,7,1,0,0
China - League Two,Shanxi Ronghai,1,0,4,2,13,0.75,1.55,7,6,2,3,2,1,0,2,1,6,1.0,0.9,5,3,0,2,0,0,0,2,1,7,0.5,2.2,2,3,2,1,2
China - League Two,Shenzhen 2028,0,0,9,7,4,1.25,0.6,10,8,2,0,0,0,0,5,2,3,1.2,0.6,4,6,0,0,0,0,0,4,5,1,1.3,0.6,6,2,2,0,0
China - League Two,Taian Tiankuang,0,2,3,7,8,0.95,1.25,4,9,6,0,1,0,1,1,5,3,1.0,1.1,2,5,3,0,0,0,1,2,2,5,0.9,1.4,2,4,3,0,1
China - League Two,Wenzhou Pro.,0,1,5,5,8,0.95,1.16,5,8,4,2,0,0,1,3,3,3,1.2,1.4,1,5,3,1,0,0,0,2,2,5,0.67,0.89,4,3,1,1,0
China - League Two,Wuhan TT B,1,1,3,8,7,1.05,0.85,7,9,4,0,0,0,0,2,3,5,0.7,0.7,4,5,1,0,0,1,1,1,5,2,1.4,1.0,3,4,3,0,0
China - League Two,Wuxi Wugou,2,1,4,6,7,1.3,0.55,11,7,2,0,0,1,0,1,4,4,1.1,0.1,9,1,0,0,0,1,1,3,2,3,1.5,1.0,2,6,2,0,0
Colombia - Primera A - Apertura,A. Bucaramanga,2,0,4,8,6,1.2,1.0,7,8,4,0,1,1,0,3,2,4,1.2,0.9,5,3,1,0,1,1,0,1,6,2,1.2,1.1,2,5,3,0,0
Colombia - Primera A - Apertura,A. Nacional,4,2,4,6,4,1.85,1.05,8,6,3,3,0,3,2,2,3,0,2.5,0.9,5,3,0,2,0,1,0,2,3,4,1.2,1.2,3,3,3,1,0
Colombia - Primera A - Apertura,A. Petrolera,1,1,3,8,7,1.15,1.05,9,3,6,2,0,1,1,1,5,2,1.6,0.8,5,2,3,0,0,0,0,2,3,5,0.7,1.3,4,1,3,2,0
Colombia - Primera A - Apertura,America de Cali,2,2,5,5,6,1.45,0.6,13,4,1,2,0,1,2,4,2,1,2.0,0.4,8,1,0,1,0,1,0,1,3,5,0.9,0.8,5,3,1,1,0
Colombia - Primera A - Apertura,Boyaca Chico,0,0,3,8,9,0.7,1.55,7,4,3,3,3,0,0,2,4,4,0.8,1.2,4,2,3,0,1,0,0,1,4,5,0.6,1.9,3,2,0,3,2
Colombia - Primera A - Apertura,D. Pereira,0,2,4,8,6,1.1,1.05,10,2,5,3,0,0,1,3,4,2,1.3,0.2,8,2,0,0,0,0,1,1,4,4,0.9,1.9,2,0,5,3,0
Colombia - Primera A - Apertura,Deportes Tolima,1,4,4,6,5,1.5,0.95,8,8,2,1,1,0,2,4,2,2,1.6,0.6,5,4,1,0,0,1,2,0,4,3,1.4,1.3,3,4,1,1,1
Colombia - Primera A - Apertura,Deportivo Cali,0,2,1,6,11,0.7,0.85,8,7,5,0,0,0,2,0,4,4,1.0,0.6,5,4,1,0,0,0,0,1,2,7,0.4,1.1,3,3,4,0,0
Colombia - Primera A - Apertura,Deportivo Pasto,0,2,3,8,7,1.0,1.0,6,10,2,2,0,0,2,3,4,1,1.6,0.8,4,5,0,1,0,0,0,0,4,6,0.4,1.2,2,5,2,1,0
Colombia - Primera A - Apertura,Envigado,0,2,3,4,11,0.8,1.45,2,12,5,0,1,0,1,1,4,4,0.9,1.8,1,5,3,0,1,0,1,2,0,7,0.7,1.1,1,7,2,0,0
Colombia - Primera A - Apertura,Fortaleza CEIF,1,0,2,7,10,0.75,1.25,7,6,5,0,2,1,0,1,4,4,1.0,1.0,5,3,1,0,1,0,0,1,3,6,0.5,1.5,2,3,4,0,1
Colombia - Primera A - Apertura,I. Medelin,0,2,3,7,8,0.95,0.55,11,7,2,0,0,0,2,2,3,3,1.3,0.3,7,3,0,0,0,0,0,1,4,5,0.6,0.8,4,4,2,0,0
Colombia - Primera A - Apertura,Junior,0,2,7,6,5,1.3,0.8,10,5,4,1,0,0,0,6,2,2,1.4,0.7,5,3,2,0,0,0,2,1,4,3,1.2,0.9,5,2,2,1,0
Colombia - Primera A - Apertura,La Equidad,0,0,3,7,10,0.65,1.75,3,7,4,4,2,0,0,3,2,5,0.8,1.4,2,5,1,1,1,0,0,0,5,5,0.5,2.1,1,2,3,3,1
Colombia - Primera A - Apertura,Llaneros,0,1,7,3,9,1.0,1.4,2,12,3,2,1,0,0,4,2,4,1.0,1.1,2,6,1,1,0,0,1,3,1,5,1.0,1.7,0,6,2,1,1
Colombia - Primera A - Apertura,Millonarios,1,1,9,5,4,1.5,0.85,11,3,4,2,0,1,0,4,2,3,1.4,0.4,7,2,1,0,0,0,1,5,3,1,1.6,1.3,4,1,3,2,0
Colombia - Primera A - Apertura,Once Caldas,0,4,4,6,6,1.3,1.1,7,6,6,0,1,0,3,3,3,1,1.8,0.8,4,4,2,0,0,0,1,1,3,5,0.8,1.4,3,2,4,0,1
Colombia - Primera A - Apertura,R. Aguilas,0,1,4,6,9,0.85,0.95,6,10,3,1,0,0,1,1,4,4,0.9,1.1,2,6,1,1,0,0,0,3,2,5,0.8,0.8,4,4,2,0,0
Colombia - Primera A - Apertura,Santa Fe,1,1,5,8,5,1.4,1.15,8,5,6,0,1,0,1,4,3,2,1.4,1.0,3,4,3,0,0,1,0,1,5,3,1.4,1.3,5,1,3,0,1
Colombia - Primera A - Apertura,Union Magdalena,0,0,2,10,8,0.7,1.5,3,7,7,3,0,0,0,2,3,5,0.7,1.5,2,3,3,2,0,0,0,0,7,3,0.7,1.5,1,4,4,1,0
Colombia - Primera B - Apertura,Atletico Cali,0,0,4,6,6,0.88,1.75,4,3,5,2,2,0,0,2,3,3,0.88,1.25,3,1,3,1,0,0,0,2,3,3,0.88,2.25,1,2,2,1,2
Colombia - Primera B - Apertura,Atletico Huila,0,2,4,5,5,1.19,0.63,8,6,2,0,0,0,0,3,3,2,1.13,0.38,6,1,1,0,0,0,2,1,2,3,1.25,0.88,2,5,1,0,0
Colombia - Primera B - Apertura,Barranquilla,0,0,4,4,8,0.75,1.69,3,5,3,4,1,0,0,3,2,3,1.0,1.13,3,2,2,1,0,0,0,1,2,5,0.5,2.25,0,3,1,3,1
Colombia - Primera B - Apertura,Boca Juniors,1,0,2,3,10,0.69,1.25,2,9,4,1,0,1,0,1,2,4,1.0,1.25,1,4,3,0,0,0,0,1,1,6,0.38,1.25,1,5,1,1,0
Colombia - Primera B - Apertura,Bogota,0,0,6,5,5,1.06,2.0,1,3,9,2,1,0,0,4,3,1,1.38,1.63,1,2,4,1,0,0,0,2,2,4,0.75,2.38,0,1,5,1,1
Colombia - Primera B - Apertura,Cucuta,2,0,7,6,1,1.75,0.88,6,6,4,0,0,2,0,3,3,0,2.13,0.88,2,5,1,0,0,0,0,4,3,1,1.38,0.88,4,1,3,0,0
Colombia - Primera B - Apertura,D. Quindio,1,0,1,7,7,0.81,1.63,4,4,5,0,3,1,0,1,2,4,1.0,1.0,3,2,3,0,0,0,0,0,5,3,0.63,2.25,1,2,2,0,3
Colombia - Primera B - Apertura,Inter Palmira,0,3,5,5,3,1.5,0.94,6,6,3,1,0,0,2,2,4,0,1.75,0.75,4,2,2,0,0,0,1,3,1,3,1.25,1.13,2,4,1,1,0
Colombia - Primera B - Apertura,Jaguares de C.,0,4,3,8,1,1.63,0.88,7,4,5,0,0,0,2,1,5,0,1.63,0.63,4,3,1,0,0,0,2,2,3,1,1.63,1.13,3,1,4,0,0
Colombia - Primera B - Apertura,Leones,1,4,0,6,5,1.38,1.5,2,6,6,2,0,1,2,0,4,1,1.75,1.38,1,4,2,1,0,0,2,0,2,4,1.0,1.63,1,2,4,1,0
Colombia - Primera B - Apertura,Orsomarso,0,1,3,6,6,0.94,1.0,6,5,4,1,0,0,1,2,2,3,1.13,1.38,2,2,3,1,0,0,0,1,4,3,0.75,0.63,4,3,1,0,0
Colombia - Primera B - Apertura,Patriotas,0,2,6,3,5,1.31,0.5,8,8,0,0,0,0,1,4,1,2,1.5,0.38,5,3,0,0,0,0,1,2,2,3,1.13,0.63,3,5,0,0,0
Colombia - Primera B - Apertura,R. Cundinamarca,2,1,2,9,2,1.56,1.0,8,3,2,3,0,1,1,1,4,1,1.75,0.63,5,1,2,0,0,1,0,1,5,1,1.38,1.38,3,2,0,3,0
Colombia - Primera B - Apertura,Real Cartagena,2,2,6,3,3,1.88,1.31,4,6,3,3,0,2,2,2,2,0,2.63,1.25,3,2,1,2,0,0,0,4,1,3,1.13,1.38,1,4,2,1,0
Colombia - Primera B - Apertura,Real Santander,0,1,3,6,6,0.94,1.44,5,4,4,1,2,0,1,1,3,3,1.0,1.25,3,3,0,1,1,0,0,2,3,3,0.88,1.63,2,1,4,0,1
Colombia - Primera B - Apertura,Tigres,0,0,5,6,5,1.0,0.88,4,10,2,0,0,0,0,3,4,1,1.25,0.5,4,4,0,0,0,0,0,2,2,4,0.75,1.25,0,6,2,0,0
Costa Rica - Primera Div. - Apertura,Alajuelense,0,0,0,0,0,,,0,0,0,0,0,0,0,0,0,0,,,0,0,0,0,0,0,0,0,0,0,,,0,0,0,0,0
Costa Rica - Primera Div. - Apertura,Cartagines,0,0,0,0,0,,,0,0,0,0,0,0,0,0,0,0,,,0,0,0,0,0,0,0,0,0,0,,,0,0,0,0,0
Costa Rica - Primera Div. - Apertura,Guadalupe,0,0,0,0,0,,,0,0,0,0,0,0,0,0,0,0,,,0,0,0,0,0,0,0,0,0,0,,,0,0,0,0,0
Costa Rica - Primera Div. - Apertura,Herediano,0,0,0,0,0,,,0,0,0,0,0,0,0,0,0,0,,,0,0,0,0,0,0,0,0,0,0,,,0,0,0,0,0
Costa Rica - Primera Div. - Apertura,M. Liberia,0,0,0,0,0,,,0,0,0,0,0,0,0,0,0,0,,,0,0,0,0,0,0,0,0,0,0,,,0,0,0,0,0
Costa Rica - Primera Div. - Apertura,Puntarenas,0,0,0,0,0,,,0,0,0,0,0,0,0,0,0,0,,,0,0,0,0,0,0,0,0,0,0,,,0,0,0,0,0
Costa Rica - Primera Div. - Apertura,San Carlos,0,0,0,0,0,,,0,0,0,0,0,0,0,0,0,0,,,0,0,0,0,0,0,0,0,0,0,,,0,0,0,0,0
Costa Rica - Primera Div. - Apertura,Saprissa,0,0,0,0,0,,,0,0,0,0,0,0,0,0,0,0,,,0,0,0,0,0,0,0,0,0,0,,,0,0,0,0,0
Costa Rica - Primera Div. - Apertura,Sporting SJ,0,0,0,0,0,,,0,0,0,0,0,0,0,0,0,0,,,0,0,0,0,0,0,0,0,0,0,,,0,0,0,0,0
Costa Rica - Primera Div. - Apertura,Zeledon,0,0,0,0,0,,,0,0,0,0,0,0,0,0,0,0,,,0,0,0,0,0,0,0,0,0,0,,,0,0,0,0,0
Costa Rica - Primera Div. - Clausura,Alajuelense,1,1,5,9,6,1.27,0.55,12,9,0,1,0,1,0,2,4,4,1.27,0.45,8,2,0,1,0,0,1,3,5,2,1.27,0.64,4,7,0,0,0
Costa Rica - Primera Div. - Clausura,Cartagines,1,2,4,10,5,1.32,0.73,7,14,1,0,0,1,2,3,3,2,1.82,0.73,4,6,1,0,0,0,0,1,7,3,0.82,0.73,3,8,0,0,0
Costa Rica - Primera Div. - Clausura,Guanacasteca,0,0,2,8,12,0.55,1.5,5,8,3,5,1,0,0,1,4,6,0.55,1.09,4,4,1,2,0,0,0,1,4,6,0.55,1.91,1,4,2,3,1
Costa Rica - Primera Div. - Clausura,Herediano,1,4,6,10,1,1.73,0.82,6,14,2,0,0,1,2,5,3,0,2.09,0.91,2,8,1,0,0,0,2,1,7,1,1.36,0.73,4,6,1,0,0
Costa Rica - Primera Div. - Clausura,M. Liberia,3,0,2,9,8,1.18,1.18,4,12,4,2,0,1,0,2,4,4,1.09,1.18,2,7,0,2,0,2,0,0,5,4,1.27,1.18,2,5,4,0,0
Costa Rica - Primera Div. - Clausura,Puntarenas,1,1,6,10,4,1.32,0.82,8,10,4,0,0,0,1,5,4,1,1.55,0.91,4,4,3,0,0,1,0,1,6,3,1.09,0.73,4,6,1,0,0
Costa Rica - Primera Div. - Clausura,San Carlos,0,1,2,9,10,0.73,1.05,6,10,5,1,0,0,1,0,5,5,0.73,0.91,3,6,2,0,0,0,0,2,4,5,0.73,1.18,3,4,3,1,0
Costa Rica - Primera Div. - Clausura,Santa Ana,0,3,2,9,8,1.0,2.0,3,6,6,4,3,0,1,2,5,3,1.09,1.55,2,4,3,1,1,0,2,0,4,5,0.91,2.45,1,2,3,3,2
Costa Rica - Primera Div. - Clausura,Santos Guapiles,0,3,4,9,6,1.18,1.5,6,6,5,4,1,0,1,4,4,2,1.36,1.18,3,5,1,2,0,0,2,0,5,4,1.0,1.82,3,1,4,2,1
Costa Rica - Primera Div. - Clausura,Saprissa,0,5,2,11,4,1.36,0.82,11,5,5,1,0,0,3,1,5,2,1.45,0.27,8,3,0,0,0,0,2,1,6,2,1.27,1.36,3,2,5,1,0
Costa Rica - Primera Div. - Clausura,Sporting SJ,0,3,5,6,8,1.14,1.27,5,10,4,2,1,0,1,3,3,4,1.09,1.45,2,6,0,2,1,0,2,2,3,4,1.18,1.09,3,4,4,0,0
Costa Rica - Primera Div. - Clausura,Zeledon,0,1,2,9,10,0.73,1.27,9,5,3,4,1,0,1,1,5,4,0.91,1.36,3,5,1,1,1,0,0,1,4,6,0.55,1.18,6,0,2,3,0
Croatia - 1. HNL,Dinamo Zagreb,0,0,0,0,0,,,0,0,0,0,0,0,0,0,0,0,,,0,0,0,0,0,0,0,0,0,0,,,0,0,0,0,0
Croatia - 1. HNL,Gorica,0,0,0,0,0,,,0,0,0,0,0,0,0,0,0,0,,,0,0,0,0,0,0,0,0,0,0,,,0,0,0,0,0
Croatia - 1. HNL,Hajduk Split,0,0,0,0,0,,,0,0,0,0,0,0,0,0,0,0,,,0,0,0,0,0,0,0,0,0,0,,,0,0,0,0,0
Croatia - 1. HNL,Istra,0,0,0,0,0,,,0,0,0,0,0,0,0,0,0,0,,,0,0,0,0,0,0,0,0,0,0,,,0,0,0,0,0
Croatia - 1. HNL,Lok. Zagreb,0,0,0,0,0,,,0,0,0,0,0,0,0,0,0,0,,,0,0,0,0,0,0,0,0,0,0,,,0,0,0,0,0
Croatia - 1. HNL,Osijek,0,0,0,0,0,,,0,0,0,0,0,0,0,0,0,0,,,0,0,0,0,0,0,0,0,0,0,,,0,0,0,0,0
Croatia - 1. HNL,Rijeka,0,0,0,0,0,,,0,0,0,0,0,0,0,0,0,0,,,0,0,0,0,0,0,0,0,0,0,,,0,0,0,0,0
Croatia - 1. HNL,Slaven Belupo,0,0,0,0,0,,,0,0,0,0,0,0,0,0,0,0,,,0,0,0,0,0,0,0,0,0,0,,,0,0,0,0,0
Croatia - 1. HNL,Varazdin,0,0,0,0,0,,,0,0,0,0,0,0,0,0,0,0,,,0,0,0,0,0,0,0,0,0,0,,,0,0,0,0,0
Croatia - 1. HNL,Vukovar,0,0,0,0,0,,,0,0,0,0,0,0,0,0,0,0,,,0,0,0,0,0,0,0,0,0,0,,,0,0,0,0,0
Croatia - 1. NL,Bijelo Brdo,1,4,5,13,10,1.21,1.27,10,12,6,3,2,0,1,4,6,5,1.06,1.31,4,6,4,1,1,1,3,1,7,5,1.35,1.24,6,6,2,2,1
Croatia - 1. NL,C. Zmijavci,1,3,4,12,13,1.0,1.3,12,8,7,3,3,1,2,2,5,6,1.19,1.19,6,6,1,1,2,0,1,2,7,7,0.82,1.41,6,2,6,2,1
Croatia - 1. NL,Cibalia,2,4,6,14,7,1.42,1.18,8,14,9,1,1,1,2,2,8,4,1.35,0.88,7,6,3,1,0,1,2,4,6,3,1.5,1.5,1,8,6,0,1
Croatia - 1. NL,Dubrava Zagreb,1,2,5,14,11,1.06,1.09,12,10,7,4,0,1,1,2,7,6,1.12,0.65,10,4,2,1,0,0,1,3,7,5,1.0,1.56,2,6,5,3,0
Croatia - 1. NL,Dugopolje,0,2,8,11,12,1.0,1.58,7,12,6,5,3,0,1,5,5,5,1.13,1.19,5,7,1,2,1,0,1,3,6,7,0.88,1.94,2,5,5,3,2
Croatia - 1. NL,Jarun,0,2,5,17,9,1.0,1.18,10,12,9,0,2,0,2,2,7,5,1.06,1.69,2,6,6,0,2,0,0,3,10,4,0.94,0.71,8,6,3,0,0
Croatia - 1. NL,Opatija,2,1,13,10,7,1.45,0.61,17,13,2,1,0,1,1,8,4,3,1.65,0.59,9,7,0,1,0,1,0,5,6,4,1.25,0.63,8,6,2,0,0
Croatia - 1. NL,Orijent,1,5,9,9,9,1.39,0.94,11,14,7,1,0,0,1,8,4,4,1.35,0.82,6,8,3,0,0,1,4,1,5,5,1.44,1.06,5,6,4,1,0
Croatia - 1. NL,Rudes,1,2,4,13,13,0.94,1.0,11,13,7,2,0,0,1,3,8,4,1.06,0.94,7,4,4,1,0,1,1,1,5,9,0.82,1.06,4,9,3,1,0
Croatia - 1. NL,Sesvete,1,5,4,9,14,1.09,0.97,13,12,4,4,0,0,4,1,7,5,1.24,1.35,4,7,2,4,0,1,1,3,2,9,0.94,0.56,9,5,2,0,0
Croatia - 1. NL,Vukovar,4,4,5,14,6,1.67,0.42,20,12,1,0,0,3,2,4,6,2,1.94,0.41,11,5,1,0,0,1,2,1,8,4,1.38,0.44,9,7,0,0,0
Croatia - 1. NL,Zrinski,0,1,3,6,23,0.45,2.15,3,10,6,11,3,0,0,1,4,11,0.38,1.88,3,5,2,5,1,0,1,2,2,12,0.53,2.41,0,5,4,6,2
Cyprus - Division 1,AEK Larnaca,3,4,11,11,7,1.61,0.83,15,13,7,1,0,2,2,8,4,2,1.89,0.72,10,4,3,1,0,1,2,3,7,5,1.33,0.94,5,9,4,0,0
Cyprus - Division 1,AEL Limassol,3,2,5,9,14,1.15,1.61,9,8,7,5,4,2,0,2,7,5,1.25,1.38,5,5,2,3,1,1,2,3,2,9,1.06,1.82,4,3,5,2,3
Cyprus - Division 1,APOEL Nicosia,5,3,8,10,10,1.64,1.0,14,11,8,3,0,3,2,4,5,4,1.89,0.83,7,8,2,1,0,2,1,4,5,6,1.39,1.17,7,3,6,2,0
Cyprus - Division 1,Achnas,0,4,12,8,9,1.33,1.61,8,8,12,2,3,0,2,6,4,5,1.29,1.18,5,5,6,1,0,0,2,6,4,4,1.38,2.06,3,3,6,1,3
Cyprus - Division 1,Anorthosis,3,4,8,10,8,1.52,1.27,11,5,14,3,0,1,3,5,6,2,1.71,1.35,5,2,9,1,0,2,1,3,4,6,1.31,1.19,6,3,5,2,0
Cyprus - Division 1,Apollon,0,4,5,15,12,1.03,1.08,13,12,7,3,1,0,4,4,7,3,1.5,0.89,7,7,3,1,0,0,0,1,8,9,0.56,1.28,6,5,4,2,1
Cyprus - Division 1,Aris,2,9,9,11,5,1.83,0.86,15,14,5,1,1,2,3,5,6,2,1.94,0.56,10,7,0,1,0,0,6,4,5,3,1.72,1.17,5,7,5,0,1
Cyprus - Division 1,Enosis P.,1,0,8,11,13,0.94,1.45,9,6,14,2,2,1,0,4,4,7,1.0,1.38,4,4,7,0,1,0,0,4,7,6,0.88,1.53,5,2,7,2,1
Cyprus - Division 1,Karmiotissa,0,1,9,9,14,0.91,1.73,7,10,6,7,3,0,1,6,4,6,1.12,1.53,5,5,3,3,1,0,0,3,5,8,0.69,1.94,2,5,3,4,2
Cyprus - Division 1,Nea Salamis,0,1,8,12,12,0.94,1.88,6,6,10,8,3,0,0,5,5,6,0.94,2.0,3,3,3,5,2,0,1,3,7,6,0.94,1.76,3,3,7,3,1
Cyprus - Division 1,O. Aradippou,1,2,8,6,16,0.97,1.76,7,11,7,4,4,1,1,5,4,6,1.24,1.59,5,4,5,1,2,0,1,3,2,10,0.69,1.94,2,7,2,3,2
Cyprus - Division 1,Omonia 29th May,0,0,5,13,15,0.7,1.97,3,10,11,4,5,0,0,4,5,7,0.81,2.0,2,4,5,3,2,0,0,1,8,8,0.59,1.94,1,6,6,1,3
Cyprus - Division 1,Omonia Nicosia,3,11,5,11,6,1.92,1.11,11,14,7,4,0,0,7,4,4,3,1.83,0.72,7,9,2,0,0,3,4,1,7,3,2.0,1.5,4,5,5,4,0
Cyprus - Division 1,Paphos,5,3,16,6,6,1.86,0.58,19,14,2,1,0,5,2,5,2,4,2.11,0.44,10,8,0,0,0,0,1,11,4,2,1.61,0.72,9,6,2,1,0
CzechRepublic - 1. Liga,Banik Ostrava,0,0,0,0,1,0.0,1.0,0,1,0,0,0,0,0,0,0,0,,,0,0,0,0,0,0,0,0,0,1,0.0,1.0,0,1,0,0,0
CzechRepublic - 1. Liga,Bohemians,0,0,0,1,0,1.0,0.0,1,0,0,0,0,0,0,0,1,0,1.0,0.0,1,0,0,0,0,0,0,0,0,0,,,0,0,0,0,0
CzechRepublic - 1. Liga,Dukla Praha,0,0,0,0,1,0.0,2.0,0,0,1,0,0,0,0,0,0,0,,,0,0,0,0,0,0,0,0,0,1,0.0,2.0,0,0,1,0,0
CzechRepublic - 1. Liga,Hradec Kralove,0,0,1,0,0,2.0,2.0,0,0,1,0,0,0,0,0,0,0,,,0,0,0,0,0,0,0,1,0,0,2.0,2.0,0,0,1,0,0
CzechRepublic - 1. Liga,Jablonec,0,0,0,1,0,1.0,1.0,0,1,0,0,0,0,0,0,1,0,1.0,1.0,0,1,0,0,0,0,0,0,0,0,,,0,0,0,0,0
CzechRepublic - 1. Liga,Karvina,0,0,1,0,0,2.0,0.0,1,0,0,0,0,0,0,1,0,0,2.0,0.0,1,0,0,0,0,0,0,0,0,0,,,0,0,0,0,0
CzechRepublic - 1. Liga,Mlada Boleslav,0,1,0,0,0,3.0,3.0,0,0,0,1,0,0,1,0,0,0,3.0,3.0,0,0,0,1,0,0,0,0,0,0,,,0,0,0,0,0
CzechRepublic - 1. Liga,Pardubice,0,0,0,1,0,1.0,5.0,0,0,0,0,1,0,0,0,1,0,1.0,5.0,0,0,0,0,1,0,0,0,0,0,,,0,0,0,0,0
CzechRepublic - 1. Liga,Sigma Olomouc,0,0,0,1,0,1.0,0.0,1,0,0,0,0,0,0,0,0,0,,,0,0,0,0,0,0,0,0,1,0,1.0,0.0,1,0,0,0,0
CzechRepublic - 1. Liga,Slavia Prague,0,0,1,0,0,2.0,2.0,0,0,1,0,0,0,0,1,0,0,2.0,2.0,0,0,1,0,0,0,0,0,0,0,,,0,0,0,0,0
CzechRepublic - 1. Liga,Slovacko,0,0,0,0,1,0.0,1.0,0,1,0,0,0,0,0,0,0,1,0.0,1.0,0,1,0,0,0,0,0,0,0,0,,,0,0,0,0,0
CzechRepublic - 1. Liga,Slovan Liberec,0,1,0,0,0,3.0,3.0,0,0,0,1,0,0,0,0,0,0,,,0,0,0,0,0,0,1,0,0,0,3.0,3.0,0,0,0,1,0
CzechRepublic - 1. Liga,Sparta Prague,0,0,0,1,0,1.0,1.0,0,1,0,0,0,0,0,0,0,0,,,0,0,0,0,0,0,0,0,1,0,1.0,1.0,0,1,0,0,0
CzechRepublic - 1. Liga,Teplice,0,0,0,1,0,1.0,3.0,0,0,0,1,0,0,0,0,1,0,1.0,3.0,0,0,0,1,0,0,0,0,0,0,,,0,0,0,0,0
CzechRepublic - 1. Liga,Viktoria Plzen,1,0,0,0,0,5.0,1.0,0,1,0,0,0,0,0,0,0,0,,,0,0,0,0,0,1,0,0,0,0,5.0,1.0,0,1,0,0,0
CzechRepublic - 1. Liga,Zlin,0,1,0,0,0,3.0,1.0,0,1,0,0,0,0,0,0,0,0,,,0,0,0,0,0,0,1,0,0,0,3.0,1.0,0,1,0,0,0
CzechRepublic - FNL,Banik Ostrava B,0,0,0,1,0,1.0,0.0,1,0,0,0,0,0,0,0,0,0,,,0,0,0,0,0,0,0,0,1,0,1.0,0.0,1,0,0,0,0
CzechRepublic - FNL,C. Budejovice,0,0,0,0,1,0.0,2.0,0,0,1,0,0,0,0,0,0,1,0.0,2.0,0,0,1,0,0,0,0,0,0,0,,,0,0,0,0,0
CzechRepublic - FNL,Chrudim,0,0,0,0,0,,,0,0,0,0,0,0,0,0,0,0,,,0,0,0,0,0,0,0,0,0,0,,,0,0,0,0,0
CzechRepublic - FNL,Han. Kromeriz,0,0,0,1,0,1.0,2.0,0,0,1,0,0,0,0,0,1,0,1.0,2.0,0,0,1,0,0,0,0,0,0,0,,,0,0,0,0,0
CzechRepublic - FNL,Jihlava,0,0,0,1,0,1.0,2.0,0,0,1,0,0,0,0,0,0,0,,,0,0,0,0,0,0,0,0,1,0,1.0,2.0,0,0,1,0,0
CzechRepublic - FNL,Lisen,0,0,0,0,0,,,0,0,0,0,0,0,0,0,0,0,,,0,0,0,0,0,0,0,0,0,0,,,0,0,0,0,0
CzechRepublic - FNL,Opava,0,0,0,1,0,1.0,0.0,1,0,0,0,0,0,0,0,0,0,,,0,0,0,0,0,0,0,0,1,0,1.0,0.0,1,0,0,0,0
CzechRepublic - FNL,Prostejov,0,0,0,0,1,0.0,1.0,0,1,0,0,0,0,0,0,0,0,,,0,0,0,0,0,0,0,0,0,1,0.0,1.0,0,1,0,0,0
CzechRepublic - FNL,Slavia Prague B,0,0,0,1,0,1.0,0.0,1,0,0,0,0,0,0,0,0,0,,,0,0,0,0,0,0,0,0,1,0,1.0,0.0,1,0,0,0,0
CzechRepublic - FNL,Sparta Prague B,0,0,0,0,1,0.0,1.0,0,1,0,0,0,0,0,0,0,1,0.0,1.0,0,1,0,0,0,0,0,0,0,0,,,0,0,0,0,0
CzechRepublic - FNL,Taborsko,0,0,0,1,0,1.0,0.0,1,0,0,0,0,0,0,0,1,0,1.0,0.0,1,0,0,0,0,0,0,0,0,0,,,0,0,0,0,0
CzechRepublic - FNL,Usti nad Labem,0,0,1,0,0,2.0,1.0,0,1,0,0,0,0,0,1,0,0,2.0,1.0,0,1,0,0,0,0,0,0,0,0,,,0,0,0,0,0
CzechRepublic - FNL,Vikto Zizkov,0,0,1,0,0,2.0,1.0,0,1,0,0,0,0,0,0,0,0,,,0,0,0,0,0,0,0,1,0,0,2.0,1.0,0,1,0,0,0
CzechRepublic - FNL,Vlasim,0,0,0,0,1,0.0,1.0,0,1,0,0,0,0,0,0,0,1,0.0,1.0,0,1,0,0,0,0,0,0,0,0,,,0,0,0,0,0
CzechRepublic - FNL,Vyskov,0,0,0,0,1,0.0,1.0,0,1,0,0,0,0,0,0,0,1,0.0,1.0,0,1,0,0,0,0,0,0,0,0,,,0,0,0,0,0
CzechRepublic - FNL,Zbrojovka Brno,0,0,1,0,0,2.0,0.0,1,0,0,0,0,0,0,0,0,0,,,0,0,0,0,0,0,0,1,0,0,2.0,0.0,1,0,0,0,0
Denmark - Superligaen,AGF Aarhus,0,0,0,1,0,1.0,1.0,0,1,0,0,0,0,0,0,0,0,,,0,0,0,0,0,0,0,0,1,0,1.0,1.0,0,1,0,0,0
Denmark - Superligaen,Brondby IF,0,1,0,0,0,3.0,0.0,1,0,0,0,0,0,1,0,0,0,3.0,0.0,1,0,0,0,0,0,0,0,0,0,,,0,0,0,0,0
Denmark - Superligaen,FC Kobenhavn,0,1,0,0,0,3.0,2.0,0,0,1,0,0,0,0,0,0,0,,,0,0,0,0,0,0,1,0,0,0,3.0,2.0,0,0,1,0,0
Denmark - Superligaen,FC Midtjylland,0,1,0,0,0,3.0,3.0,0,0,0,1,0,0,1,0,0,0,3.0,3.0,0,0,0,1,0,0,0,0,0,0,,,0,0,0,0,0
Denmark - Superligaen,Fredericia,0,0,1,0,0,2.0,3.0,0,0,0,1,0,0,0,1,0,0,2.0,3.0,0,0,0,1,0,0,0,0,0,0,,,0,0,0,0,0
Denmark - Superligaen,Nordsjaelland,0,1,0,0,0,3.0,2.0,0,0,1,0,0,0,0,0,0,0,,,0,0,0,0,0,0,1,0,0,0,3.0,2.0,0,0,1,0,0
Denmark - Superligaen,Odense BK,0,1,0,0,0,3.0,3.0,0,0,0,1,0,0,0,0,0,0,,,0,0,0,0,0,0,1,0,0,0,3.0,3.0,0,0,0,1,0
Denmark - Superligaen,Randers FC,0,0,0,1,0,1.0,1.0,0,1,0,0,0,0,0,0,0,0,,,0,0,0,0,0,0,0,0,1,0,1.0,1.0,0,1,0,0,0
Denmark - Superligaen,Silkeborg,0,0,0,0,1,0.0,3.0,0,0,0,1,0,0,0,0,0,0,,,0,0,0,0,0,0,0,0,0,1,0.0,3.0,0,0,0,1,0
Denmark - Superligaen,SonderjyskE,0,0,0,1,0,1.0,1.0,0,1,0,0,0,0,0,0,1,0,1.0,1.0,0,1,0,0,0,0,0,0,0,0,,,0,0,0,0,0
Denmark - Superligaen,Vejle BK,0,0,0,1,0,1.0,1.0,0,1,0,0,0,0,0,0,1,0,1.0,1.0,0,1,0,0,0,0,0,0,0,0,,,0,0,0,0,0
Denmark - Superligaen,Viborg,0,0,1,0,0,2.0,3.0,0,0,0,1,0,0,0,1,0,0,2.0,3.0,0,0,0,1,0,0,0,0,0,0,,,0,0,0,0,0
Denmark - 1st Division,AC Horsens,0,0,0,0,1,0.0,0.0,1,0,0,0,0,0,0,0,0,1,0.0,0.0,1,0,0,0,0,0,0,0,0,0,,,0,0,0,0,0
Denmark - 1st Division,Aalborg BK,0,0,0,0,1,0.0,1.0,0,1,0,0,0,0,0,0,0,0,,,0,0,0,0,0,0,0,0,0,1,0.0,1.0,0,1,0,0,0
Denmark - 1st Division,Aarhus Fremad,0,0,0,0,1,0.0,0.0,1,0,0,0,0,0,0,0,0,0,,,0,0,0,0,0,0,0,0,0,1,0.0,0.0,1,0,0,0,0
Denmark - 1st Division,B 93,0,0,0,1,0,1.0,1.0,0,1,0,0,0,0,0,0,0,0,,,0,0,0,0,0,0,0,0,1,0,1.0,1.0,0,1,0,0,0
Denmark - 1st Division,Esbjerg,0,0,0,0,1,0.0,2.0,0,0,1,0,0,0,0,0,0,1,0.0,2.0,0,0,1,0,0,0,0,0,0,0,,,0,0,0,0,0
Denmark - 1st Division,HB Koge,0,0,1,0,0,2.0,0.0,1,0,0,0,0,0,0,1,0,0,2.0,0.0,1,0,0,0,0,0,0,0,0,0,,,0,0,0,0,0
Denmark - 1st Division,Hillerod,0,0,1,0,0,2.0,1.0,0,1,0,0,0,0,0,1,0,0,2.0,1.0,0,1,0,0,0,0,0,0,0,0,,,0,0,0,0,0
Denmark - 1st Division,Hobro,0,0,0,0,1,0.0,2.0,0,0,1,0,0,0,0,0,0,0,,,0,0,0,0,0,0,0,0,0,1,0.0,2.0,0,0,1,0,0
Denmark - 1st Division,Hvidovre,0,0,0,1,0,1.0,1.0,0,1,0,0,0,0,0,0,1,0,1.0,1.0,0,1,0,0,0,0,0,0,0,0,,,0,0,0,0,0
Denmark - 1st Division,Kolding IF,0,0,0,1,0,1.0,0.0,1,0,0,0,0,0,0,0,1,0,1.0,0.0,1,0,0,0,0,0,0,0,0,0,,,0,0,0,0,0
Denmark - 1st Division,Lyngby,0,0,1,0,0,2.0,0.0,1,0,0,0,0,0,0,0,0,0,,,0,0,0,0,0,0,0,1,0,0,2.0,0.0,1,0,0,0,0
Denmark - 1st Division,Middelfart,0,0,0,1,0,1.0,2.0,0,0,1,0,0,0,0,0,0,0,,,0,0,0,0,0,0,0,0,1,0,1.0,2.0,0,0,1,0,0
Denmark - 2nd Division,AB Copenhagen,0,0,0,0,0,,,0,0,0,0,0,0,0,0,0,0,,,0,0,0,0,0,0,0,0,0,0,,,0,0,0,0,0
Denmark - 2nd Division,Brabrand,0,0,0,0,0,,,0,0,0,0,0,0,0,0,0,0,,,0,0,0,0,0,0,0,0,0,0,,,0,0,0,0,0
Denmark - 2nd Division,Fremad Amager,0,0,0,0,0,,,0,0,0,0,0,0,0,0,0,0,,,0,0,0,0,0,0,0,0,0,0,,,0,0,0,0,0
Denmark - 2nd Division,Hellerup IK,0,0,0,0,0,,,0,0,0,0,0,0,0,0,0,0,,,0,0,0,0,0,0,0,0,0,0,,,0,0,0,0,0
Denmark - 2nd Division,Helsingor,0,0,0,0,0,,,0,0,0,0,0,0,0,0,0,0,,,0,0,0,0,0,0,0,0,0,0,,,0,0,0,0,0
Denmark - 2nd Division,Ishoj,0,0,0,0,0,,,0,0,0,0,0,0,0,0,0,0,,,0,0,0,0,0,0,0,0,0,0,,,0,0,0,0,0
Denmark - 2nd Division,Naestved,0,0,0,0,0,,,0,0,0,0,0,0,0,0,0,0,,,0,0,0,0,0,0,0,0,0,0,,,0,0,0,0,0
Denmark - 2nd Division,Roskilde,0,0,0,0,0,,,0,0,0,0,0,0,0,0,0,0,,,0,0,0,0,0,0,0,0,0,0,,,0,0,0,0,0
Denmark - 2nd Division,Skive,0,0,0,0,0,,,0,0,0,0,0,0,0,0,0,0,,,0,0,0,0,0,0,0,0,0,0,,,0,0,0,0,0
Denmark - 2nd Division,Thisted,0,0,0,0,0,,,0,0,0,0,0,0,0,0,0,0,,,0,0,0,0,0,0,0,0,0,0,,,0,0,0,0,0
Denmark - 2nd Division,VSK Arhus,0,0,0,0,0,,,0,0,0,0,0,0,0,0,0,0,,,0,0,0,0,0,0,0,0,0,0,,,0,0,0,0,0
Denmark - 2nd Division,Vendsyssel,0,0,0,0,0,,,0,0,0,0,0,0,0,0,0,0,,,0,0,0,0,0,0,0,0,0,0,,,0,0,0,0,0
Egypt - Premier League,Al Ahly,5,2,7,8,3,2.08,0.72,13,7,4,1,0,4,0,6,3,0,2.69,0.77,6,4,3,0,0,1,2,1,5,3,1.42,0.67,7,3,1,1,0
Egypt - Premier League,Al Ittihad,0,0,2,10,13,0.56,0.84,11,9,3,2,0,0,0,0,6,5,0.55,0.82,5,4,1,1,0,0,0,2,4,8,0.57,0.86,6,5,2,1,0
Egypt - Premier League,Al Masry,2,1,5,8,9,1.16,0.8,14,6,3,0,2,2,0,2,2,6,1.17,0.75,8,1,2,0,1,0,1,3,6,3,1.15,0.85,6,5,1,0,1
Egypt - Premier League,Ceramica C.,3,0,8,10,4,1.52,1.32,8,9,5,0,3,2,0,4,5,2,1.62,1.62,2,6,3,0,2,1,0,4,5,2,1.42,1.0,6,3,2,0,1
Egypt - Premier League,ENPPI,0,1,2,11,11,0.72,1.04,9,10,3,2,1,0,0,1,6,5,0.67,0.92,4,6,1,1,0,0,1,1,5,6,0.77,1.15,5,4,2,1,1
Egypt - Premier League,El Geish,0,1,3,9,12,0.72,0.96,10,7,7,1,0,0,0,2,5,7,0.64,1.0,4,6,4,0,0,0,1,1,4,5,0.82,0.91,6,1,3,1,0
Egypt - Premier League,El Gouna,1,1,4,5,14,0.8,0.88,11,9,3,1,1,0,0,3,3,6,0.75,0.67,5,6,1,0,0,1,1,1,2,8,0.85,1.08,6,3,2,1,1
Egypt - Premier League,Ghazl El M.,1,1,3,7,13,0.8,1.44,7,8,4,4,2,0,1,2,3,7,0.77,1.46,4,5,0,2,2,1,0,1,4,6,0.83,1.42,3,3,4,2,0
Egypt - Premier League,Haras El Hodood,0,1,4,9,11,0.8,1.4,9,3,9,3,1,0,1,1,6,4,0.92,0.92,6,2,3,1,0,0,0,3,3,7,0.69,1.85,3,1,6,2,1
Egypt - Premier League,Ismaily,0,2,2,8,13,0.72,1.12,8,8,8,0,1,0,1,1,5,6,0.77,1.23,5,2,5,0,1,0,1,1,3,7,0.67,1.0,3,6,3,0,0
Egypt - Premier League,Modern Sport,0,0,6,9,10,0.84,1.24,9,8,3,3,2,0,0,3,3,6,0.75,1.0,6,3,0,3,0,0,0,3,6,4,0.92,1.46,3,5,3,0,2
Egypt - Premier League,National Bank,3,1,5,10,6,1.4,1.2,8,6,9,2,0,1,1,2,3,4,1.27,1.18,3,3,5,0,0,2,0,3,7,2,1.5,1.21,5,3,4,2,0
Egypt - Premier League,Petrojet,0,0,7,10,8,0.96,1.4,6,9,6,2,2,0,0,4,4,6,0.86,1.29,4,4,4,2,0,0,0,3,6,2,1.09,1.55,2,5,2,0,2
Egypt - Premier League,Pharco,1,2,6,3,13,1.0,1.4,6,9,7,2,1,1,2,3,3,6,1.27,1.27,3,6,5,1,0,0,0,3,0,7,0.6,1.6,3,3,2,1,1
Egypt - Premier League,Pyramids FC,1,6,8,8,2,1.88,0.8,11,11,1,1,1,0,5,2,2,1,2.1,0.5,5,5,0,0,0,1,1,6,6,1,1.73,1.0,6,6,1,1,1
Egypt - Premier League,Smouha,0,1,2,8,14,0.6,1.12,9,9,4,1,2,0,0,2,3,7,0.58,1.42,4,4,1,1,2,0,1,0,5,7,0.62,0.85,5,5,3,0,0
Egypt - Premier League,ZED FC,0,1,6,9,9,0.96,0.72,11,10,4,0,0,0,0,4,4,6,0.86,0.79,6,5,3,0,0,0,1,2,5,3,1.09,0.64,5,5,1,0,0
Egypt - Premier League,Zamalek,2,5,8,5,5,1.76,0.88,10,9,5,1,0,1,3,3,3,2,1.83,0.83,4,6,2,0,0,1,2,5,2,3,1.69,0.92,6,3,3,1,0
Ecuador - Liga Pro,Aucas,1,0,5,14,1,1.33,1.24,7,6,5,2,1,1,0,5,5,0,1.73,1.27,4,3,2,1,1,0,0,0,9,1,0.9,1.2,3,3,3,1,0
Ecuador - Liga Pro,Barcelona SC,2,2,4,10,3,1.57,1.19,9,4,4,3,1,0,1,3,4,2,1.3,1.1,5,2,1,1,1,2,1,1,6,1,1.82,1.27,4,2,3,2,0
Ecuador - Liga Pro,Cuniburo,1,2,4,7,7,1.24,1.38,4,7,8,2,0,1,1,1,5,2,1.5,1.3,2,4,3,1,0,0,1,3,2,5,1.0,1.45,2,3,5,1,0
Ecuador - Liga Pro,D. Cuenca,1,2,4,8,6,1.24,0.95,9,7,3,1,1,1,1,3,3,2,1.6,0.7,4,5,1,0,0,0,1,1,5,4,0.91,1.18,5,2,2,1,1
Ecuador - Liga Pro,Delfin,0,1,6,5,9,0.95,1.38,7,6,4,2,2,0,1,2,3,5,0.91,0.73,6,4,0,0,1,0,0,4,2,4,1.0,2.1,1,2,4,2,1
Ecuador - Liga Pro,El Nacional,0,4,3,6,8,1.14,1.43,4,10,3,2,2,0,1,2,2,5,0.9,1.2,3,4,1,2,0,0,3,1,4,3,1.36,1.64,1,6,2,0,2
Ecuador - Liga Pro,Emelec,0,0,3,10,8,0.76,1.14,6,8,6,0,1,0,0,2,5,4,0.82,0.91,5,4,1,0,1,0,0,1,5,4,0.7,1.4,1,4,5,0,0
Ecuador - Liga Pro,I. del Valle,2,3,7,8,1,1.86,0.9,4,15,2,0,0,1,0,3,6,0,1.6,0.9,2,7,1,0,0,1,3,4,2,1,2.09,0.91,2,8,1,0,0
Ecuador - Liga Pro,LDU Quito,2,4,5,7,3,1.76,1.0,6,10,4,1,0,1,4,3,2,1,2.18,0.91,4,4,3,0,0,1,0,2,5,2,1.3,1.1,2,6,1,1,0
Ecuador - Liga Pro,Libertad,2,2,4,9,4,1.48,1.24,4,12,2,2,1,2,1,3,3,2,1.82,1.27,2,7,0,1,1,0,1,1,6,2,1.1,1.2,2,5,2,1,0
Ecuador - Liga Pro,Macara,1,1,2,8,9,0.9,1.0,5,13,2,0,1,0,0,1,6,4,0.73,1.0,2,7,2,0,0,1,1,1,2,5,1.1,1.0,3,6,0,0,1
Ecuador - Liga Pro,Manta,2,0,7,5,7,1.29,1.62,1,9,8,3,0,2,0,5,2,1,2.0,1.6,1,4,3,2,0,0,0,2,3,6,0.64,1.64,0,5,5,1,0
Ecuador - Liga Pro,Mushuc Runa,1,1,3,11,5,1.14,1.81,2,9,5,3,2,1,1,3,4,1,1.7,2.1,2,3,1,2,2,0,0,0,7,4,0.64,1.55,0,6,4,1,0
Ecuador - Liga Pro,Orense,1,1,5,6,8,1.14,1.14,6,10,3,0,2,0,1,4,4,2,1.36,0.82,3,7,1,0,0,1,0,1,2,6,0.9,1.5,3,3,2,0,2
Ecuador - Liga Pro,Tecnico U.,0,0,2,15,4,0.9,1.57,5,5,7,2,2,0,0,1,8,2,0.91,1.36,2,4,4,1,0,0,0,1,7,2,0.9,1.8,3,1,3,1,2
Ecuador - Liga Pro,U. Catolica,1,4,4,10,2,1.62,1.33,6,8,2,4,1,0,3,2,4,1,1.7,0.9,4,4,1,1,0,1,1,2,6,1,1.55,1.73,2,4,1,3,1
Ecuador - Serie B,22 de Julio,0,1,4,7,7,0.95,1.53,7,4,5,1,2,0,1,1,5,2,1.11,0.44,5,4,0,0,0,0,0,3,2,5,0.8,2.5,2,0,5,1,2
Ecuador - Serie B,Chacaritas,0,2,2,6,9,0.84,2.16,2,5,5,4,3,0,2,1,4,2,1.33,1.44,1,4,3,1,0,0,0,1,2,7,0.4,2.8,1,1,2,3,3
Ecuador - Serie B,Cumbaya,1,0,4,6,8,0.95,1.05,7,7,3,1,1,1,0,2,3,4,1.1,0.9,5,2,2,1,0,0,0,2,3,4,0.78,1.22,2,5,1,0,1
Ecuador - Serie B,Gualaceo,0,2,7,5,4,1.39,1.28,5,5,6,2,0,0,2,5,2,0,2.0,1.11,3,2,4,0,0,0,0,2,3,4,0.78,1.44,2,3,2,2,0
Ecuador - Serie B,Guayaquil City,2,2,3,6,5,1.56,0.78,8,7,2,1,0,2,2,2,1,2,2.33,0.78,4,3,2,0,0,0,0,1,5,3,0.78,0.78,4,4,0,1,0
Ecuador - Serie B,I. Juniors,0,3,3,4,8,1.06,1.11,7,5,4,1,1,0,2,1,4,2,1.33,0.56,5,3,1,0,0,0,1,2,0,6,0.78,1.67,2,2,3,1,1
Ecuador - Serie B,Imbabura,2,0,2,7,7,1.06,1.44,3,7,5,3,0,2,0,0,3,4,1.22,0.89,3,4,2,0,0,0,0,2,4,3,0.89,2.0,0,3,3,3,0
Ecuador - Serie B,Leones Norte,0,1,5,7,5,1.11,0.61,10,5,3,0,0,0,1,3,4,1,1.44,0.44,6,2,1,0,0,0,0,2,3,4,0.78,0.78,4,3,2,0,0
Ecuador - Serie B,Nueve Octubre,0,1,4,7,6,1.0,0.67,7,10,1,0,0,0,1,2,3,3,1.11,0.56,5,3,1,0,0,0,0,2,4,3,0.89,0.78,2,7,0,0,0
Ecuador - Serie B,San Antonio,0,0,5,8,5,1.0,0.89,7,8,2,0,1,0,0,4,3,2,1.22,0.78,4,3,2,0,0,0,0,1,5,3,0.78,1.0,3,5,0,0,1
Ecuador - Serie B,Vargas Torres,1,2,3,10,3,1.37,1.11,7,5,5,2,0,1,1,2,5,1,1.6,0.7,5,3,2,0,0,0,1,1,5,2,1.11,1.56,2,2,3,2,0
Ecuador - Serie B,Vinotinto,2,3,4,2,7,1.72,1.28,4,7,5,2,0,2,3,1,1,2,2.67,0.89,3,4,2,0,0,0,0,3,1,5,0.78,1.67,1,3,3,2,0
England - Premier League,Arsenal,5,3,12,13,5,1.82,0.89,13,16,9,0,0,2,2,7,6,2,1.84,0.89,7,7,5,0,0,3,1,5,7,3,1.79,0.89,6,9,4,0,0
England - Premier League,Aston Villa,1,6,12,12,7,1.53,1.34,9,13,12,2,2,1,3,8,5,2,1.79,1.05,4,10,5,0,0,0,3,4,7,5,1.26,1.63,5,3,7,2,2
England - Premier League,Bournemouth,3,4,10,13,8,1.53,1.21,9,15,11,3,0,1,1,3,9,5,1.21,0.84,7,8,4,0,0,2,3,7,4,3,1.84,1.58,2,7,7,3,0
England - Premier League,Brentford,8,2,6,14,8,1.74,1.5,8,10,13,7,0,6,2,3,3,5,2.11,1.84,1,6,7,5,0,2,0,3,11,3,1.37,1.16,7,4,6,2,0
England - Premier League,Brighton,2,6,15,10,5,1.74,1.55,8,13,11,3,3,0,4,7,4,4,1.58,1.37,3,8,6,2,0,2,2,8,6,1,1.89,1.74,5,5,5,1,3
England - Premier League,Chelsea,5,4,7,15,7,1.68,1.13,11,14,10,3,0,2,3,5,8,1,1.84,0.95,6,8,5,0,0,3,1,2,7,6,1.53,1.32,5,6,5,3,0
England - Premier League,Crystal Palace,2,1,13,14,8,1.34,1.34,11,12,12,0,3,2,0,4,8,5,1.26,1.37,4,7,7,0,1,0,1,9,6,3,1.42,1.32,7,5,5,0,2
England - Premier League,Everton,2,2,9,10,15,1.11,1.16,12,15,6,3,2,2,1,6,3,7,1.37,1.21,6,5,6,2,0,0,1,3,7,8,0.84,1.11,6,10,0,1,2
England - Premier League,Fulham,0,4,15,12,7,1.42,1.42,5,18,10,4,1,0,3,6,6,4,1.42,1.58,2,8,6,2,1,0,1,9,6,3,1.42,1.26,3,10,4,2,0
England - Premier League,Ipswich Town,0,1,10,13,14,0.95,2.16,2,13,11,3,9,0,0,3,8,8,0.74,2.32,1,5,7,1,5,0,1,7,5,6,1.16,2.0,1,8,4,2,4
England - Premier League,Leicester City,0,2,8,11,17,0.87,2.11,3,7,16,7,5,0,1,3,6,9,0.79,1.79,3,4,7,4,1,0,1,5,5,8,0.95,2.42,0,3,9,3,4
England - Premier League,Liverpool,4,6,21,6,1,2.26,1.08,14,12,7,5,0,2,3,11,2,1,2.21,0.84,6,10,3,0,0,2,3,10,4,0,2.32,1.32,8,2,4,5,0
England - Premier League,Manchester City,5,5,12,10,6,1.89,1.16,13,11,12,0,2,4,4,5,4,2,2.26,1.21,5,7,6,0,1,1,1,7,6,4,1.53,1.11,8,4,6,0,1
England - Premier League,Manchester Utd,1,6,6,10,15,1.16,1.42,10,11,10,5,2,1,3,3,4,8,1.21,1.47,5,5,4,5,0,0,3,3,6,7,1.11,1.37,5,6,6,0,2
England - Premier League,Newcastle Utd,5,7,7,12,7,1.79,1.24,13,14,4,3,4,4,4,3,5,3,2.11,1.05,8,6,2,2,1,1,3,4,7,4,1.47,1.42,5,8,2,1,3
England - Premier League,Nottm Forest,2,6,7,15,8,1.53,1.21,13,12,8,3,2,1,2,2,9,5,1.37,0.84,8,7,3,1,0,1,4,5,6,3,1.68,1.58,5,5,5,2,2
England - Premier League,Southampton,0,0,4,18,16,0.68,2.26,3,10,7,13,5,0,0,2,9,8,0.68,2.47,2,4,3,6,4,0,0,2,9,8,0.68,2.05,1,6,4,7,1
England - Premier League,Tottenham,6,5,6,12,9,1.68,1.71,6,14,11,2,5,3,4,2,7,3,1.84,1.84,2,7,7,0,3,3,1,4,5,6,1.53,1.58,4,7,4,2,2
England - Premier League,West Ham Utd,1,2,9,18,8,1.21,1.63,7,15,7,5,4,1,1,5,6,6,1.21,1.79,2,8,5,2,2,0,1,4,12,2,1.21,1.47,5,7,2,3,2
England - Premier League,Wolverhampton,2,3,11,15,7,1.42,1.82,8,8,13,4,5,1,1,6,8,3,1.42,1.68,5,3,8,1,2,1,2,5,7,4,1.42,1.95,3,5,5,3,3
England - Championship,Blackburn,2,3,10,16,15,1.15,1.04,15,16,13,2,0,2,2,8,4,7,1.48,1.0,8,7,8,0,0,0,1,2,12,8,0.83,1.09,7,9,5,2,0
England - Championship,Bristol City,2,2,15,15,12,1.28,1.2,10,24,6,5,1,2,1,9,7,4,1.57,0.87,7,13,2,1,0,0,1,6,8,8,1.0,1.52,3,11,4,4,1
England - Championship,Burnley,6,1,14,11,14,1.5,0.35,30,16,0,0,0,3,1,6,7,6,1.52,0.35,15,8,0,0,0,3,0,8,4,8,1.48,0.35,15,8,0,0,0
England - Championship,Cardiff City,1,1,11,18,15,1.04,1.59,8,17,15,2,4,1,1,3,10,8,1.04,1.17,6,8,8,1,0,0,0,8,8,7,1.04,2.0,2,9,7,1,4
England - Championship,Coventry City,1,7,11,17,10,1.39,1.26,13,13,16,3,1,1,5,7,7,3,1.74,1.04,9,4,10,0,0,0,2,4,10,7,1.04,1.48,4,9,6,3,1
England - Championship,Derby County,1,3,10,15,17,1.04,1.22,12,19,11,1,3,1,1,6,6,9,1.09,0.78,10,9,3,1,0,0,2,4,9,8,1.0,1.65,2,10,8,0,3
England - Championship,Hull City,1,4,4,20,17,0.96,1.17,7,28,8,2,1,1,1,4,9,8,1.04,1.22,2,15,5,1,0,0,3,0,11,9,0.87,1.13,5,13,3,1,1
England - Championship,Leeds Utd,6,8,17,8,7,2.07,0.65,25,15,3,3,0,4,6,10,2,1,2.65,0.52,14,7,1,1,0,2,2,7,6,6,1.48,0.78,11,8,2,2,0
England - Championship,Luton Town,0,3,8,20,15,0.98,1.5,11,17,9,4,5,0,2,4,11,6,1.09,0.96,7,12,3,0,1,0,1,4,9,9,0.87,2.04,4,5,6,4,4
England - Championship,Middlesbrough,3,5,9,16,13,1.39,1.22,13,17,9,7,0,1,2,7,6,7,1.35,1.0,8,10,2,3,0,2,3,2,10,6,1.43,1.43,5,7,7,4,0
England - Championship,Millwall,0,4,6,23,13,1.02,1.07,16,20,5,2,3,0,3,4,10,6,1.17,0.83,8,12,2,1,0,0,1,2,13,7,0.87,1.3,8,8,3,1,3
England - Championship,Norwich City,7,3,6,19,11,1.54,1.48,8,15,18,4,1,7,2,4,7,3,2.26,1.48,3,11,6,2,1,0,1,2,12,8,0.83,1.48,5,4,12,2,0
England - Championship,Oxford Utd,0,4,7,23,12,1.07,1.41,13,13,12,6,2,0,3,5,12,3,1.35,1.26,9,6,4,3,1,0,1,2,11,9,0.78,1.57,4,7,8,3,1
England - Championship,Plymouth,1,5,10,11,19,1.11,1.91,3,20,11,6,6,1,5,7,6,4,1.74,1.7,1,12,5,4,1,0,0,3,5,15,0.48,2.13,2,8,6,2,5
England - Championship,Portsmouth,3,4,8,17,14,1.26,1.54,10,16,11,6,3,2,3,4,8,6,1.43,0.91,9,9,3,2,0,1,1,4,9,8,1.09,2.17,1,7,8,4,3
England - Championship,Preston,0,3,7,25,11,1.04,1.28,13,14,12,7,0,0,2,4,12,5,1.13,0.96,8,9,5,1,0,0,1,3,13,6,0.96,1.61,5,5,7,6,0
England - Championship,QP Rangers,1,3,10,20,12,1.15,1.37,10,18,12,4,2,1,2,5,11,4,1.35,1.48,5,9,5,2,2,0,1,5,9,8,0.96,1.26,5,9,7,2,0
England - Championship,Sheffield Utd,0,3,18,18,7,1.37,0.78,22,14,8,2,0,0,3,7,10,3,1.43,0.74,12,7,2,2,0,0,0,11,8,4,1.3,0.83,10,7,6,0,0
England - Championship,Sheffield Wed,2,5,12,13,14,1.3,1.5,9,17,13,4,3,2,1,6,7,7,1.3,1.39,4,10,8,0,1,0,4,6,6,7,1.3,1.61,5,7,5,4,2
England - Championship,Stoke City,1,2,8,17,18,0.98,1.35,14,13,12,5,2,1,2,4,9,7,1.26,1.09,8,7,6,2,0,0,0,4,8,11,0.7,1.61,6,6,6,3,2
England - Championship,Sunderland,1,3,16,13,13,1.26,0.96,17,16,11,2,0,1,0,11,6,5,1.39,0.78,9,10,4,0,0,0,3,5,7,8,1.13,1.13,8,6,7,2,0
England - Championship,Swansea City,0,6,9,15,16,1.11,1.22,14,19,6,4,3,0,6,3,9,5,1.43,1.04,10,6,4,2,1,0,0,6,6,11,0.78,1.39,4,13,2,2,2
England - Championship,Watford,1,2,9,23,11,1.15,1.33,12,14,15,3,2,0,1,6,12,4,1.17,0.96,9,8,5,0,1,1,1,3,11,7,1.13,1.7,3,6,10,3,1
England - Championship,West Brom,2,3,10,18,13,1.24,1.02,14,20,9,3,0,2,1,7,6,7,1.43,0.87,10,8,3,2,0,0,2,3,12,6,1.04,1.17,4,12,6,1,0
England - League One,Barnsley,3,4,15,15,9,1.5,1.59,6,19,14,4,3,2,1,7,8,5,1.43,1.57,3,8,9,2,1,1,3,8,7,4,1.57,1.61,3,11,5,2,2
England - League One,Birmingham City,4,5,18,15,4,1.83,0.67,22,19,3,2,0,4,2,8,7,2,2.04,0.48,14,7,2,0,0,0,3,10,8,2,1.61,0.87,8,12,1,2,0
England - League One,Blackpool,2,8,13,14,9,1.57,1.3,13,14,14,3,2,1,4,7,5,6,1.52,1.26,6,7,8,2,0,1,4,6,9,3,1.61,1.35,7,7,6,1,2
England - League One,Bolton,4,5,11,13,13,1.46,1.52,9,16,14,3,4,2,4,5,5,7,1.57,1.39,4,9,8,1,1,2,1,6,8,6,1.35,1.65,5,7,6,2,3
England - League One,Bristol Rovers,0,6,4,18,18,0.96,1.65,9,12,15,7,3,0,5,3,10,5,1.35,1.43,5,7,8,2,1,0,1,1,8,13,0.57,1.87,4,5,7,5,2
England - League One,Burton Albion,1,3,9,18,15,1.07,1.43,12,12,12,10,0,1,2,6,8,6,1.3,1.48,4,8,7,4,0,0,1,3,10,9,0.83,1.39,8,4,5,6,0
England - League One,Cambridge Utd,2,1,8,18,17,0.98,1.59,7,17,16,2,4,2,1,3,8,9,1.09,1.43,3,12,5,1,2,0,0,5,10,8,0.87,1.74,4,5,11,1,2
England - League One,Charlton,3,2,17,14,10,1.46,0.93,20,14,8,3,1,1,2,10,8,2,1.65,0.7,11,8,4,0,0,2,0,7,6,8,1.26,1.17,9,6,4,3,1
England - League One,Crawley Town,2,8,4,17,15,1.24,1.8,10,14,7,7,8,0,6,2,9,6,1.35,1.52,4,10,5,2,2,2,2,2,8,9,1.13,2.09,6,4,2,5,6
England - League One,Exeter City,1,2,10,19,14,1.07,1.41,15,10,13,5,3,1,2,5,10,5,1.3,1.43,8,4,8,1,2,0,0,5,9,9,0.83,1.39,7,6,5,4,1
England - League One,Huddersfield,3,1,14,14,14,1.26,1.2,14,17,9,4,2,1,1,6,7,8,1.17,1.04,7,11,3,1,1,2,0,8,7,6,1.35,1.35,7,6,6,3,1
England - League One,Leyton Orient,5,8,7,12,14,1.57,1.04,18,11,14,3,0,1,5,3,8,6,1.43,0.83,13,2,7,1,0,4,3,4,4,8,1.7,1.26,5,9,7,2,0
England - League One,Lincoln City,5,3,10,13,15,1.39,1.22,13,18,8,6,1,5,0,5,5,8,1.61,1.04,7,10,4,2,0,0,3,5,8,7,1.17,1.39,6,8,4,4,1
England - League One,Mansfield,1,5,13,15,12,1.3,1.59,8,18,9,8,3,1,2,6,8,6,1.3,1.48,4,10,5,3,1,0,3,7,7,6,1.3,1.7,4,8,4,5,2
England - League One,Northampton,2,3,6,19,16,1.04,1.43,11,16,12,3,4,1,2,4,6,10,1.04,1.35,6,8,7,0,2,1,1,2,13,6,1.04,1.52,5,8,5,3,2
England - League One,Peterborough,5,4,6,21,10,1.48,1.76,6,16,11,10,3,3,4,1,9,6,1.65,1.57,3,10,5,4,1,2,0,5,12,4,1.3,1.96,3,6,6,6,2
England - League One,Reading,3,5,14,12,12,1.48,1.24,13,21,4,5,3,2,3,7,6,5,1.61,0.91,9,11,0,2,1,1,2,7,6,7,1.35,1.57,4,10,4,3,2
England - League One,Rotherham,1,5,11,13,16,1.17,1.28,10,21,9,4,2,1,3,9,4,6,1.52,1.3,4,12,4,2,1,0,2,2,9,10,0.83,1.26,6,9,5,2,1
England - League One,Shrewsbury,1,2,7,16,20,0.89,1.72,4,20,12,5,5,0,2,3,8,10,0.87,1.61,3,9,7,2,2,1,0,4,8,10,0.91,1.83,1,11,5,3,3
England - League One,Stevenage,1,4,2,22,17,0.91,1.09,17,14,10,4,1,1,3,2,11,6,1.22,1.13,7,10,3,2,1,0,1,0,11,11,0.61,1.04,10,4,7,2,0
England - League One,Stockport,2,7,12,18,7,1.57,0.91,17,21,6,0,2,2,3,9,6,3,1.83,0.96,10,9,2,0,2,0,4,3,12,4,1.3,0.87,7,12,4,0,0
England - League One,Wigan Athletic,1,1,7,19,18,0.87,0.91,18,15,12,1,0,0,1,4,9,9,0.87,1.0,8,8,6,1,0,1,0,3,10,9,0.87,0.83,10,7,6,0,0
England - League One,Wrexham,1,6,14,17,8,1.46,0.74,24,12,8,2,0,1,6,5,9,2,1.78,0.65,13,6,3,1,0,0,0,9,8,6,1.13,0.83,11,6,5,1,0
England - League One,Wycombe,2,6,15,13,10,1.52,0.98,17,18,7,3,1,0,2,7,7,7,1.17,0.78,12,8,0,2,1,2,4,8,6,3,1.87,1.17,5,10,7,1,0
England - League Two,AFC Wimbledon,2,5,9,15,15,1.22,0.76,21,16,8,1,0,2,3,5,8,5,1.52,0.7,13,4,6,0,0,0,2,4,7,10,0.91,0.83,8,12,2,1,0
England - League Two,Accrington,1,4,9,18,14,1.15,1.5,13,10,15,4,4,1,3,4,7,8,1.26,1.35,7,6,6,3,1,0,1,5,11,6,1.04,1.65,6,4,9,1,3
England - League Two,Barrow,1,4,12,12,17,1.13,1.09,14,20,6,6,0,1,3,7,7,5,1.48,0.96,9,9,2,3,0,0,1,5,5,12,0.78,1.22,5,11,4,3,0
England - League Two,Bradford,2,6,10,18,10,1.39,0.98,16,20,7,2,1,1,5,6,8,3,1.7,0.57,11,11,1,0,0,1,1,4,10,7,1.09,1.39,5,9,6,2,1
England - League Two,Bromley,2,4,11,21,8,1.39,1.28,16,13,9,5,3,2,1,7,9,4,1.52,1.13,8,7,6,1,1,0,3,4,12,4,1.26,1.43,8,6,3,4,2
England - League Two,Carlisle Utd,0,2,11,16,17,0.96,1.54,10,15,11,7,3,0,2,6,7,8,1.09,1.52,4,8,8,2,1,0,0,5,9,9,0.83,1.57,6,7,3,5,2
England - League Two,Cheltenham,0,7,13,13,13,1.3,1.52,8,15,16,6,1,0,4,6,8,5,1.39,1.35,4,11,6,1,1,0,3,7,5,8,1.22,1.7,4,4,10,5,0
England - League Two,Chesterfield,5,6,8,16,11,1.59,1.17,14,17,9,5,1,2,4,5,10,2,1.78,1.17,6,10,4,3,0,3,2,3,6,9,1.39,1.17,8,7,5,2,1
England - League Two,Colchester Utd,1,4,7,22,12,1.13,1.02,21,14,4,3,4,1,2,4,10,6,1.22,0.65,12,7,4,0,0,0,2,3,12,6,1.04,1.39,9,7,0,3,4
England - League Two,Crewe Alexandra,1,5,6,18,16,1.07,1.04,16,20,5,3,2,1,4,4,6,8,1.3,1.17,8,10,1,2,2,0,1,2,12,8,0.83,0.91,8,10,4,1,0
England - League Two,Doncaster,2,8,12,17,7,1.59,1.09,13,21,9,2,1,1,4,6,10,2,1.65,1.0,7,10,5,1,0,1,4,6,7,5,1.52,1.17,6,11,4,1,1
England - League Two,Fleetwood,4,1,14,11,16,1.3,1.3,16,11,11,5,3,0,0,9,6,8,1.04,0.91,12,5,4,0,2,4,1,5,5,8,1.57,1.7,4,6,7,5,1
England - League Two,Gillingham,1,1,3,28,13,0.89,1.0,17,15,11,3,0,1,1,2,13,6,1.04,0.87,11,5,6,1,0,0,0,1,15,7,0.74,1.13,6,10,5,2,0
England - League Two,Grimsby,1,6,11,16,12,1.33,1.46,10,17,10,6,3,1,3,4,8,7,1.3,1.52,3,11,5,2,2,0,3,7,8,5,1.35,1.39,7,6,5,4,1
England - League Two,Harrogate,0,3,10,14,19,0.93,1.33,11,17,12,5,1,0,2,6,8,7,1.13,1.35,6,8,6,2,1,0,1,4,6,12,0.74,1.3,5,9,6,3,0
England - League Two,Milton Keynes,1,7,7,12,19,1.13,1.43,9,20,10,4,3,0,4,4,5,10,1.09,1.09,6,12,3,1,1,1,3,3,7,9,1.17,1.78,3,8,7,3,2
England - League Two,Morecambe,1,2,8,14,21,0.87,1.57,7,17,14,6,2,1,1,5,7,9,1.04,1.57,5,7,6,4,1,0,1,3,7,12,0.7,1.57,2,10,8,2,1
England - League Two,Newport,1,6,8,12,19,1.13,1.65,13,10,10,8,5,1,5,2,7,8,1.39,1.39,7,7,4,3,2,0,1,6,5,11,0.87,1.91,6,3,6,5,3
England - League Two,Notts County,3,4,14,15,10,1.48,1.07,16,15,11,4,0,1,2,5,11,4,1.35,0.91,10,6,6,1,0,2,2,9,4,6,1.61,1.22,6,9,5,3,0
England - League Two,Port Vale,2,6,11,16,11,1.41,1.0,18,16,7,4,1,1,4,6,5,7,1.48,0.78,10,9,3,1,0,1,2,5,11,4,1.35,1.22,8,7,4,3,1
England - League Two,Salford City,1,6,12,18,9,1.39,1.17,13,16,14,2,1,1,3,5,9,5,1.39,1.22,7,7,7,1,1,0,3,7,9,4,1.39,1.13,6,9,7,1,0
England - League Two,Swindon Town,5,7,7,14,13,1.54,1.37,11,17,11,4,3,2,6,4,4,7,1.7,1.43,7,6,5,3,2,3,1,3,10,6,1.39,1.3,4,11,6,1,1
England - League Two,Tranmere,2,1,9,16,18,0.98,1.41,12,16,7,10,1,1,0,6,8,8,1.04,0.96,8,10,3,2,0,1,1,3,8,10,0.91,1.87,4,6,4,8,1
England - League Two,Walsall,5,3,17,11,10,1.63,1.17,15,15,12,3,1,3,3,9,6,2,2.0,1.39,5,10,5,2,1,2,0,8,5,8,1.26,0.96,10,5,7,1,0
England - National League,AFC Fylde,1,5,9,12,19,1.09,1.85,6,15,13,5,7,1,4,5,8,5,1.52,1.7,5,5,8,3,2,0,1,4,4,14,0.65,2.0,1,10,5,2,5
England - National League,Aldershot Town,2,8,13,11,12,1.5,1.8,7,15,13,6,5,2,6,7,2,6,1.83,1.52,4,8,7,3,1,0,2,6,9,6,1.17,2.09,3,7,6,3,4
England - National League,Altrincham,3,5,11,18,9,1.48,1.35,12,16,13,3,2,2,2,5,10,4,1.48,0.91,7,11,5,0,0,1,3,6,8,5,1.48,1.78,5,5,8,3,2
England - National League,Barnet,6,13,8,14,5,2.11,0.83,22,16,3,4,1,4,7,6,5,1,2.52,0.65,10,12,0,1,0,2,6,2,9,4,1.7,1.0,12,4,3,3,1
England - National League,Boston Utd,0,7,10,13,16,1.17,1.46,10,17,10,6,3,0,3,5,9,6,1.22,1.35,5,9,6,2,1,0,4,5,4,10,1.13,1.57,5,8,4,4,2
England - National League,Braintree Town,1,2,12,17,14,1.11,1.28,14,15,8,8,1,0,0,7,7,9,0.91,0.78,10,9,3,1,0,1,2,5,10,5,1.3,1.78,4,6,5,7,1
England - National League,Dagenham & R.,3,3,6,23,11,1.33,1.35,10,18,12,4,2,3,3,4,10,3,1.91,1.52,5,7,7,2,2,0,0,2,13,8,0.74,1.17,5,11,5,2,0
England - National League,Eastleigh,2,2,11,22,9,1.26,1.33,12,12,18,3,1,2,1,5,14,1,1.52,1.17,6,8,8,1,0,0,1,6,8,8,1.0,1.48,6,4,10,2,1
England - National League,Ebbsfleet Utd,1,1,9,13,22,0.83,2.13,7,8,15,7,9,1,0,4,6,12,0.78,1.78,5,5,8,2,3,0,1,5,7,10,0.87,2.48,2,3,7,5,6
England - National League,Forest Green,2,5,14,18,7,1.5,0.91,16,21,6,3,0,0,3,10,9,1,1.65,0.74,10,10,2,1,0,2,2,4,9,6,1.35,1.09,6,11,4,2,0
England - National League,Gateshead FC,7,4,9,16,10,1.65,1.48,11,16,9,9,1,4,1,5,7,6,1.61,1.35,6,8,4,5,0,3,3,4,9,4,1.7,1.61,5,8,5,4,1
England - National League,Halifax Town,1,4,7,20,14,1.09,1.0,17,16,9,4,0,0,2,4,8,9,0.96,1.04,7,9,6,1,0,1,2,3,12,5,1.22,0.96,10,7,3,3,0
England - National League,Hartlepool,3,4,9,17,13,1.28,1.35,12,19,7,5,3,2,2,5,5,9,1.26,1.0,8,9,4,2,0,1,2,4,12,4,1.3,1.7,4,10,3,3,3
England - National League,Maidenhead Utd,1,7,9,14,15,1.24,1.63,9,19,6,7,5,1,5,3,7,7,1.39,1.57,2,13,4,2,2,0,2,6,7,8,1.09,1.7,7,6,2,5,3
England - National League,Oldham,2,4,12,20,8,1.39,1.04,16,17,9,3,1,2,2,6,9,4,1.52,1.0,10,6,4,3,0,0,2,6,11,4,1.26,1.09,6,11,5,0,1
England - National League,Rochdale,5,7,7,13,14,1.5,0.96,18,19,5,1,3,5,4,3,4,7,1.87,0.91,11,8,1,1,2,0,3,4,9,7,1.13,1.0,7,11,4,0,1
England - National League,Solihull Moors,3,4,9,17,13,1.33,1.46,6,25,5,8,2,2,3,6,5,7,1.48,1.74,1,13,2,5,2,1,1,3,12,6,1.17,1.17,5,12,3,3,0
England - National League,Southend Utd,3,2,14,13,14,1.28,1.04,18,13,10,5,0,1,2,9,5,6,1.43,1.04,9,7,4,3,0,2,0,5,8,8,1.13,1.04,9,6,6,2,0
England - National League,Sutton Utd,1,5,7,25,8,1.28,1.39,12,16,9,6,3,1,1,3,14,4,1.22,1.3,7,6,6,4,0,0,4,4,11,4,1.35,1.48,5,10,3,2,3
England - National League,Tamworth,3,6,9,17,11,1.41,1.57,6,20,13,5,2,3,4,3,10,3,1.74,1.22,3,13,6,1,0,0,2,6,7,8,1.09,1.91,3,7,7,4,2
England - National League,Wealdstone,1,5,10,17,13,1.22,1.65,7,17,10,9,3,1,5,2,8,7,1.35,1.48,5,9,3,5,1,0,0,8,9,6,1.09,1.83,2,8,7,4,2
England - National League,Woking,0,4,11,18,13,1.13,1.28,10,19,12,4,1,0,3,3,12,5,1.17,0.96,8,9,5,1,0,0,1,8,6,8,1.09,1.61,2,10,7,3,1
England - National League,Yeovil Town,1,6,6,17,16,1.11,1.3,12,18,10,3,3,0,3,4,8,8,1.09,1.17,4,12,6,1,0,1,3,2,9,8,1.13,1.43,8,6,4,2,3
England - National League,York City,6,9,12,14,5,2.07,0.91,21,12,9,4,0,5,5,5,6,2,2.48,0.87,11,5,6,1,0,1,4,7,8,3,1.65,0.96,10,7,3,3,0
FaroeIslands - Premier League,07 Vestur,1,2,0,9,4,1.25,2.13,2,3,5,3,3,1,1,0,4,2,1.5,1.88,1,2,3,1,1,0,1,0,5,2,1.0,2.38,1,1,2,2,2
FaroeIslands - Premier League,B36 Torshavn,0,5,2,8,1,1.69,1.5,4,3,7,1,1,0,1,2,5,1,1.33,1.22,3,2,3,1,0,0,4,0,3,0,2.14,1.86,1,1,4,0,1
FaroeIslands - Premier League,B68 Toftir,1,1,5,5,4,1.38,2.13,2,7,3,2,2,1,0,4,1,2,1.63,1.5,1,4,2,0,1,0,1,1,4,2,1.13,2.75,1,3,1,2,1
FaroeIslands - Premier League,HB Torshavn,4,3,5,3,1,2.38,1.69,3,7,3,1,2,2,2,2,2,0,2.5,2.13,1,3,2,1,1,2,1,3,1,1,2.25,1.25,2,4,1,0,1
FaroeIslands - Premier League,Klaksvik,6,3,5,2,0,3.25,0.5,9,6,1,0,0,3,2,3,0,0,3.75,0.63,4,3,1,0,0,3,1,2,2,0,2.75,0.38,5,3,0,0,0
FaroeIslands - Premier League,NSI Runavik,9,1,2,4,0,4.0,1.31,5,5,3,2,1,4,0,0,4,0,3.38,1.38,3,2,1,1,1,5,1,2,0,0,4.63,1.25,2,3,2,1,0
FaroeIslands - Premier League,Streymur,0,0,5,7,4,1.06,1.69,5,3,4,1,3,0,0,2,3,2,1.0,1.86,2,1,2,1,1,0,0,3,4,2,1.11,1.56,3,2,2,0,2
FaroeIslands - Premier League,Suduroy,1,0,2,4,9,0.75,2.63,1,3,4,4,4,1,0,1,2,4,1.0,3.0,1,0,2,3,2,0,0,1,2,5,0.5,2.25,0,3,2,1,2
FaroeIslands - Premier League,TB Tvoroyri,0,0,4,6,6,0.88,3.31,0,6,1,2,7,0,0,2,4,3,0.89,2.67,0,5,0,1,3,0,0,2,2,3,0.86,4.14,0,1,1,1,4
FaroeIslands - Premier League,Vikingur,1,2,3,4,6,1.25,1.0,4,9,2,1,0,1,1,1,0,4,1.29,1.14,1,5,0,1,0,0,1,2,4,2,1.22,0.89,3,4,2,0,0
Finland - Veikkausliiga,Gnistan,0,1,7,4,4,1.31,1.69,5,2,5,3,1,0,0,5,1,1,1.57,1.29,2,1,4,0,0,0,1,2,3,3,1.11,2.0,3,1,1,3,1
Finland - Veikkausliiga,HJK Helsinki,4,4,3,1,4,2.19,1.13,5,7,1,3,0,2,3,1,0,2,2.38,1.25,1,5,1,1,0,2,1,2,1,2,2.0,1.0,4,2,0,2,0
Finland - Veikkausliiga,Haka,0,1,5,4,6,1.06,1.69,1,8,3,3,1,0,1,2,1,4,1.0,1.75,0,5,1,1,1,0,0,3,3,2,1.13,1.63,1,3,2,2,0
Finland - Veikkausliiga,Ilves,2,5,5,3,2,2.18,1.12,7,4,3,3,0,0,4,3,0,1,2.25,1.38,2,2,3,1,0,2,1,2,3,1,2.11,0.89,5,2,0,2,0
Finland - Veikkausliiga,Inter Turku,2,3,4,6,1,2.0,0.75,7,6,3,0,0,1,3,0,3,1,2.13,0.63,3,5,0,0,0,1,0,4,3,0,1.88,0.88,4,1,3,0,0
Finland - Veikkausliiga,Jaro,0,1,4,6,5,1.06,1.56,3,6,2,5,0,0,0,2,2,3,0.86,1.57,0,5,0,2,0,0,1,2,4,2,1.22,1.56,3,1,2,3,0
Finland - Veikkausliiga,KTP,0,2,4,4,6,1.13,2.38,2,1,7,3,3,0,1,3,1,4,1.11,1.89,2,1,4,1,1,0,1,1,3,2,1.14,3.0,0,0,3,2,2
Finland - Veikkausliiga,KuPS,2,3,2,5,5,1.65,1.06,6,6,3,2,0,2,2,0,3,2,2.11,0.89,5,1,2,1,0,0,1,2,2,3,1.13,1.25,1,5,1,1,0
Finland - Veikkausliiga,Mariehamn,0,1,2,9,4,1.0,1.94,4,2,6,0,4,0,1,1,4,2,1.13,2.25,1,1,4,0,2,0,0,1,5,2,0.88,1.63,3,1,2,0,2
Finland - Veikkausliiga,Oulu,0,3,4,5,4,1.38,2.19,1,4,5,3,3,0,1,4,1,2,1.5,2.38,0,2,3,1,2,0,2,0,4,2,1.25,2.0,1,2,2,2,1
Finland - Veikkausliiga,SJK,1,4,6,3,2,1.94,1.44,2,8,4,1,1,1,3,2,2,1,2.11,1.22,1,6,1,1,0,0,1,4,1,1,1.71,1.71,1,2,3,0,1
Finland - Veikkausliiga,VPS,2,1,3,6,4,1.5,1.56,4,2,7,3,0,1,0,0,3,4,0.88,1.25,3,1,3,1,0,1,1,3,3,0,2.13,1.88,1,1,4,2,0
Finland - Ykkonen,Ekenas IF,3,3,4,4,2,2.06,1.31,4,6,4,1,1,3,2,1,1,1,2.63,1.38,2,3,2,0,1,0,1,3,3,1,1.5,1.25,2,3,2,1,0
Finland - Ykkonen,JIPPO,0,3,2,9,2,1.38,1.44,2,8,3,3,0,0,3,1,3,1,1.75,1.38,1,4,2,1,0,0,0,1,6,1,1.0,1.5,1,4,1,2,0
Finland - Ykkonen,JaPS,2,0,5,6,3,1.63,2.5,1,5,3,1,6,1,0,3,3,1,1.63,2.38,1,2,2,1,2,1,0,2,3,2,1.63,2.63,0,3,1,0,4
Finland - Ykkonen,KaPa,1,3,4,4,4,1.56,2.88,0,4,3,3,6,1,1,1,3,2,1.5,2.25,0,3,2,2,1,0,2,3,1,2,1.63,3.5,0,1,1,1,5
Finland - Ykkonen,Klubi-04,3,3,2,5,2,2.07,1.87,2,5,5,1,2,1,2,1,2,1,2.0,2.14,0,3,3,0,1,2,1,1,3,1,2.13,1.63,2,2,2,1,1
Finland - Ykkonen,Lahti,1,2,8,4,1,1.94,1.06,7,3,4,2,0,1,1,4,2,0,2.25,1.13,3,2,2,1,0,0,1,4,2,1,1.63,1.0,4,1,2,1,0
Finland - Ykkonen,PK-35,2,1,3,8,2,1.56,1.13,3,9,3,1,0,1,1,2,3,1,1.75,1.0,3,3,1,1,0,1,0,1,5,1,1.38,1.25,0,6,2,0,0
Finland - Ykkonen,SJK Akatemia,2,3,3,4,4,1.75,1.88,2,5,3,5,1,2,2,0,2,2,2.13,2.0,0,4,1,2,1,0,1,3,2,2,1.38,1.75,2,1,2,3,0
Finland - Ykkonen,SalPa,0,1,1,7,6,0.8,1.87,3,3,4,3,2,0,0,0,5,3,0.63,1.0,3,2,3,0,0,0,1,1,2,3,1.0,2.86,0,1,1,3,2
Finland - Ykkonen,TPS,5,3,7,1,0,2.88,1.75,2,4,7,2,1,3,2,3,0,0,3.0,1.5,1,2,5,0,0,2,1,4,1,0,2.75,2.0,1,2,2,2,1
Finland - Kakkonen,Atlantis,0,1,4,4,6,1.0,1.6,6,3,2,2,2,0,0,2,2,3,0.86,1.14,3,1,2,1,0,0,1,2,2,3,1.13,2.0,3,2,0,1,2
Finland - Kakkonen,EPS,0,2,2,5,6,1.0,2.27,3,5,1,1,5,0,2,1,3,2,1.38,1.88,2,3,0,1,2,0,0,1,2,4,0.57,2.71,1,2,1,0,3
Finland - Kakkonen,Inter Turku B,5,1,4,3,2,2.73,1.8,2,5,3,4,1,3,0,2,1,1,3.14,1.14,2,3,1,1,0,2,1,2,2,1,2.38,2.38,0,2,2,3,1
Finland - Kakkonen,JJK,2,1,2,6,4,1.47,1.27,3,7,4,0,1,2,1,1,3,1,2.13,1.13,2,5,0,0,1,0,0,1,3,3,0.71,1.43,1,2,4,0,0
Finland - Kakkonen,Jazz Pori,2,2,3,5,2,2.0,1.29,5,3,3,3,0,2,2,2,0,1,3.0,1.29,2,2,2,1,0,0,0,1,5,1,1.0,1.29,3,1,1,2,0
Finland - Kakkonen,KPV Kokkola,0,2,2,8,3,1.2,1.67,4,5,3,1,2,0,2,1,4,0,1.71,1.0,4,1,1,0,1,0,0,1,4,3,0.75,2.25,0,4,2,1,1
Finland - Kakkonen,KuPS Ak.,2,1,3,6,3,1.67,1.67,3,5,4,2,1,2,0,2,3,1,2.13,1.13,2,4,1,1,0,0,1,1,3,2,1.14,2.29,1,1,3,1,1
Finland - Kakkonen,Mikkelin,1,1,4,3,5,1.29,1.29,5,4,2,2,1,0,1,2,1,3,1.14,0.71,3,3,1,0,0,1,0,2,2,2,1.43,1.86,2,1,1,2,1
Finland - Kakkonen,OLS Oulu,3,2,5,3,2,2.2,1.4,2,7,5,0,1,2,1,3,1,0,2.86,1.14,1,4,2,0,0,1,1,2,2,2,1.63,1.63,1,3,3,0,1
Finland - Kakkonen,PKKU,2,4,4,2,3,2.07,1.8,4,3,4,1,3,1,3,2,0,2,2.13,1.88,2,2,2,0,2,1,1,2,2,1,2.0,1.71,2,1,2,1,1
Finland - Kakkonen,Rovaniemi,2,1,3,5,4,1.47,1.73,3,5,4,1,2,1,1,3,1,2,1.75,1.63,1,4,2,0,1,1,0,0,4,2,1.14,1.86,2,1,2,1,1
Finland - Kakkonen,Tampere Utd,1,1,5,4,4,1.4,1.67,4,2,6,2,1,0,0,3,3,1,1.29,1.29,3,0,3,1,0,1,1,2,1,3,1.5,2.0,1,2,3,1,1
Finland - Kakkonen - A,GrIFK,2,3,1,6,2,1.93,1.93,2,3,4,4,1,2,1,1,1,2,2.29,2.0,1,1,2,3,0,0,2,0,5,0,1.57,1.86,1,2,2,1,1
Finland - Kakkonen - A,HaPK,0,0,3,5,6,0.79,3.71,1,2,3,2,6,0,0,2,3,2,1.0,3.86,0,2,1,2,2,0,0,1,2,4,0.57,3.57,1,0,2,0,4
Finland - Kakkonen - A,Honka,9,3,0,2,0,4.29,0.86,6,5,2,1,0,6,0,0,1,0,4.0,0.86,4,1,1,1,0,3,3,0,1,0,4.57,0.86,2,4,1,0,0
Finland - Kakkonen - A,JPS,1,2,1,4,6,1.21,4.07,0,1,2,4,7,1,1,0,2,3,1.43,4.0,0,1,1,2,3,0,1,1,2,3,1.0,4.14,0,0,1,2,4
Finland - Kakkonen - A,MYPA,5,2,3,1,3,2.79,1.86,5,1,2,5,1,3,0,2,1,1,2.57,2.29,2,1,0,3,1,2,2,1,0,2,3.0,1.43,3,0,2,2,0
Finland - Kakkonen - A,PEPO,1,1,5,6,1,1.64,1.57,3,7,1,0,3,1,0,4,2,0,2.0,0.86,2,4,1,0,0,0,1,1,4,1,1.29,2.29,1,3,0,0,3
Finland - Kakkonen - A,PuiU Helsinki,1,3,4,2,4,1.79,1.57,5,5,0,1,3,1,1,2,2,1,2.14,0.86,3,3,0,1,0,0,2,2,0,3,1.43,2.29,2,2,0,0,3
Finland - Kakkonen - A,Reipas,2,4,1,6,1,2.14,2.5,0,4,5,2,3,2,1,0,3,1,2.29,2.43,0,2,2,2,1,0,3,1,3,0,2.0,2.57,0,2,3,0,2
Finland - Kakkonen - A,VJS,6,2,2,3,1,3.21,0.93,5,7,1,0,1,4,1,0,2,0,3.71,0.86,2,4,1,0,0,2,1,2,1,1,2.71,1.0,3,3,0,0,1
Finland - Kakkonen - A,Vaajakoski,2,2,2,4,4,1.71,2.5,1,4,2,3,4,1,1,1,1,3,1.57,2.0,1,2,1,2,1,1,1,1,3,1,1.86,3.0,0,2,1,1,3
Finland - Kakkonen - B,Atlantis B,0,2,3,4,5,1.14,3.57,0,0,5,4,5,0,1,1,2,3,1.0,4.14,0,0,2,1,4,0,1,2,2,2,1.29,3.0,0,0,3,3,1
Finland - Kakkonen - B,HJS,3,2,5,3,1,2.29,1.43,3,6,2,2,1,1,2,3,0,1,2.29,2.29,0,2,2,2,1,2,0,2,3,0,2.29,0.57,3,4,0,0,0
Finland - Kakkonen - B,HPS,0,2,3,7,2,1.36,1.79,2,6,0,5,1,0,2,0,4,1,1.43,1.29,2,3,0,2,0,0,0,3,3,1,1.29,2.29,0,3,0,3,1
Finland - Kakkonen - B,Ilves B,3,0,7,4,0,2.5,1.36,4,5,3,1,1,2,0,3,2,0,3.0,1.43,2,3,1,0,1,1,0,4,2,0,2.0,1.29,2,2,2,1,0
Finland - Kakkonen - B,Kiffen,2,2,4,4,2,2.0,1.57,3,5,3,1,2,0,1,3,3,0,1.71,1.57,2,2,1,1,1,2,1,1,1,2,2.29,1.57,1,3,2,0,1
Finland - Kakkonen - B,MuSa,1,2,1,8,2,1.64,1.93,2,6,4,0,2,0,0,1,4,2,0.86,1.29,1,3,3,0,0,1,2,0,4,0,2.43,2.57,1,3,1,0,2
Finland - Kakkonen - B,NJS,1,2,2,6,3,1.43,2.43,0,6,3,3,2,1,1,0,5,0,1.71,1.71,0,4,1,2,0,0,1,2,1,3,1.14,3.14,0,2,2,1,2
Finland - Kakkonen - B,P-Iirot,3,2,3,5,1,2.14,1.29,3,6,3,2,0,1,1,1,3,1,1.71,1.57,1,2,3,1,0,2,1,2,2,0,2.57,1.0,2,4,0,1,0
Finland - Kakkonen - B,PPJ,2,3,2,4,3,2.07,2.36,0,3,6,2,3,2,2,2,1,0,3.29,2.29,0,1,4,1,1,0,1,0,3,3,0.86,2.43,0,2,2,1,2
Finland - Kakkonen - B,TPV,3,4,3,2,2,2.57,1.43,4,4,4,1,1,3,1,0,1,2,2.86,0.86,3,2,2,0,0,0,3,3,1,0,2.29,2.0,1,2,2,1,1
Finland - Kakkonen - C,GBK Kokkola,0,6,2,3,2,1.92,2.08,2,3,3,4,1,0,4,1,1,1,2.14,1.86,1,2,1,3,0,0,2,1,2,1,1.67,2.33,1,1,2,1,1
Finland - Kakkonen - C,JBK,1,3,3,3,3,1.69,1.54,2,6,2,2,1,1,2,1,1,1,2.17,1.17,1,3,2,0,0,0,1,2,2,2,1.29,1.86,1,3,0,2,1
Finland - Kakkonen - C,JS Hercules,1,2,1,6,2,1.5,3.67,0,0,6,1,5,0,1,1,3,1,1.33,3.33,0,0,3,1,2,1,1,0,3,1,1.67,4.0,0,0,3,0,3
Finland - Kakkonen - C,Kuopion Elo,0,0,0,0,0,,,0,0,0,0,0,0,0,0,0,0,,,0,0,0,0,0,0,0,0,0,0,,,0,0,0,0,0
Finland - Kakkonen - C,Narpes Kraft,0,3,5,3,2,1.69,2.15,1,3,4,3,2,0,1,4,0,1,1.83,2.33,0,1,2,3,0,0,2,1,3,1,1.57,2.0,1,2,2,0,2
Finland - Kakkonen - C,OsPa,5,1,2,3,1,2.75,2.0,0,6,2,3,1,4,0,0,1,1,3.33,1.5,0,4,1,1,0,1,1,2,2,0,2.17,2.5,0,2,1,2,1
Finland - Kakkonen - C,SJK Akatemia B,3,3,4,2,1,2.85,2.54,1,2,3,3,4,2,0,3,2,0,2.86,2.43,0,2,1,3,1,1,3,1,0,1,2.83,2.67,1,0,2,0,3
Finland - Kakkonen - C,TP-47,4,3,1,3,1,2.75,2.25,1,4,3,2,2,3,2,0,1,0,3.5,2.17,1,0,3,1,1,1,1,1,2,1,2.0,2.33,0,4,0,1,1
Finland - Kakkonen - C,VIFK,2,1,4,4,2,1.85,2.31,1,2,4,5,1,2,0,0,3,2,1.71,1.43,1,2,4,0,0,0,1,4,1,0,2.0,3.33,0,0,0,5,1
Finland - Kakkonen - C,VPS B,2,3,6,1,1,2.62,1.15,7,2,1,2,1,2,2,1,1,0,3.5,0.67,4,1,0,1,0,0,1,5,0,1,1.86,1.57,3,1,1,1,1
France - Ligue 1,Angers,1,2,5,12,14,0.94,1.56,7,11,9,4,3,1,0,5,4,7,1.06,1.94,3,4,4,3,3,0,2,0,8,7,0.82,1.18,4,7,5,1,0
France - Ligue 1,Auxerre,2,3,9,13,7,1.41,1.5,10,7,8,8,1,1,2,4,6,4,1.41,1.0,7,5,3,2,0,1,1,5,7,3,1.41,2.0,3,2,5,6,1
France - Ligue 1,Brest,3,2,12,10,7,1.53,1.74,10,8,5,7,4,2,1,8,4,2,1.82,1.24,7,6,1,1,2,1,1,4,6,5,1.24,2.24,3,2,4,6,2
France - Ligue 1,Le Havre,1,3,6,15,9,1.18,2.09,4,10,7,7,6,0,2,0,9,6,0.88,2.41,1,5,2,5,4,1,1,6,6,3,1.47,1.76,3,5,5,2,2
France - Ligue 1,Lens,1,3,9,11,10,1.24,1.15,13,9,8,2,2,1,2,2,5,7,1.12,1.29,8,1,5,1,2,0,1,7,6,3,1.35,1.0,5,8,3,1,0
France - Ligue 1,Lille,1,4,12,12,5,1.53,1.06,11,14,6,2,1,1,3,5,8,0,1.82,1.06,4,10,1,2,0,0,1,7,4,5,1.24,1.06,7,4,5,0,1
France - Ligue 1,Lyon,7,2,11,9,5,1.91,1.35,10,10,7,6,1,5,0,7,3,2,2.18,1.24,6,4,4,3,0,2,2,4,6,3,1.65,1.47,4,6,3,3,1
France - Ligue 1,Marseille,7,6,8,7,6,2.18,1.38,5,17,6,6,0,5,2,4,4,2,2.41,1.35,2,9,4,2,0,2,4,4,3,4,1.94,1.41,3,8,2,4,0
France - Ligue 1,Monaco,2,8,9,10,5,1.85,1.21,11,11,9,0,3,2,5,5,2,3,2.24,0.94,7,6,3,0,1,0,3,4,8,2,1.47,1.47,4,5,6,0,2
France - Ligue 1,Montpellier,0,2,5,7,20,0.68,2.32,1,10,11,5,7,0,2,3,5,7,1.0,2.41,1,3,6,3,4,0,0,2,2,13,0.35,2.24,0,7,5,2,3
France - Ligue 1,Nantes,0,3,7,16,8,1.15,1.53,6,14,9,3,2,0,2,3,7,5,1.12,1.06,5,6,6,0,0,0,1,4,9,3,1.18,2.0,1,8,3,3,2
France - Ligue 1,Nice,4,4,10,12,4,1.94,1.21,8,13,12,0,1,2,1,8,5,1,2.24,0.88,6,7,4,0,0,2,3,2,7,3,1.65,1.53,2,6,8,0,1
France - Ligue 1,Paris SG,11,9,3,10,1,2.71,1.03,7,20,6,1,0,4,6,2,5,0,2.65,0.94,4,11,1,1,0,7,3,1,5,1,2.76,1.12,3,9,5,0,0
France - Ligue 1,Reims,1,3,5,10,15,0.97,1.38,7,13,10,2,2,1,1,2,6,7,1.0,1.47,2,7,7,0,1,0,2,3,4,8,0.94,1.29,5,6,3,2,1
France - Ligue 1,Rennes,3,3,7,14,7,1.5,1.47,11,8,7,4,4,1,2,3,8,3,1.47,1.0,8,3,5,0,1,2,1,4,6,4,1.53,1.94,3,5,2,4,3
France - Ligue 1,Saint-Etienne,0,4,7,13,10,1.15,2.26,5,9,7,6,7,0,4,3,6,4,1.41,1.94,3,4,4,5,1,0,0,4,7,6,0.88,2.59,2,5,3,1,6
France - Ligue 1,Strasbourg,1,7,10,11,5,1.65,1.29,10,12,6,4,2,1,4,7,3,2,1.94,1.18,4,8,3,2,0,0,3,3,8,3,1.35,1.41,6,4,3,2,2
France - Ligue 1,Toulouse,2,2,8,14,8,1.29,1.26,10,10,10,3,1,0,0,5,10,2,1.18,1.29,4,7,4,1,1,2,2,3,4,6,1.41,1.24,6,3,6,2,0
France - Ligue 2,AC Ajaccio,0,1,9,9,15,0.88,1.24,8,15,7,3,1,0,1,7,5,4,1.29,1.0,5,8,3,1,0,0,0,2,4,11,0.47,1.47,3,7,4,2,1
France - Ligue 2,Amiens,1,3,5,15,10,1.12,1.47,9,10,6,8,1,1,3,2,9,2,1.53,1.18,7,4,3,2,1,0,0,3,6,8,0.71,1.76,2,6,3,6,0
France - Ligue 2,Annecy,0,2,12,12,8,1.24,1.26,16,7,4,2,5,0,2,6,6,3,1.41,0.94,10,3,1,1,2,0,0,6,6,5,1.06,1.59,6,4,3,1,3
France - Ligue 2,Caen,0,2,7,11,14,0.91,1.71,4,12,10,6,2,0,1,4,4,8,0.88,1.41,2,8,5,2,0,0,1,3,7,6,0.94,2.0,2,4,5,4,2
France - Ligue 2,Clermont,1,1,5,13,14,0.88,1.35,5,17,7,5,0,1,1,2,6,7,1.0,1.12,1,13,3,0,0,0,0,3,7,7,0.76,1.59,4,4,4,5,0
France - Ligue 2,Grenoble,2,5,5,10,12,1.26,1.29,9,10,11,4,0,0,4,4,5,4,1.47,1.0,5,7,5,0,0,2,1,1,5,8,1.06,1.59,4,3,6,4,0
France - Ligue 2,Guingamp,2,8,6,13,5,1.68,1.32,11,11,4,6,2,1,6,4,3,3,1.94,1.12,6,6,3,1,1,1,2,2,10,2,1.41,1.53,5,5,1,5,1
France - Ligue 2,Laval,0,7,5,13,9,1.29,1.12,11,13,7,2,1,0,3,4,7,3,1.41,1.06,5,7,4,1,0,0,4,1,6,6,1.18,1.18,6,6,3,1,1
France - Ligue 2,Lorient,6,6,9,6,7,2.0,0.91,13,13,6,2,0,6,5,4,0,2,2.88,0.71,8,6,3,0,0,0,1,5,6,5,1.12,1.12,5,7,3,2,0
France - Ligue 2,Martigues,1,2,4,11,16,0.85,1.65,7,14,5,3,5,0,1,3,4,9,0.76,1.59,3,7,3,2,2,1,1,1,7,7,0.94,1.71,4,7,2,1,3
France - Ligue 2,Metz,3,9,6,10,6,1.88,1.0,10,15,8,1,0,2,5,3,5,2,2.18,0.88,6,8,2,1,0,1,4,3,5,4,1.59,1.12,4,7,6,0,0
France - Ligue 2,Paris FC,2,7,7,12,6,1.62,0.97,15,8,8,3,0,2,4,4,6,1,2.0,0.94,8,3,5,1,0,0,3,3,6,5,1.24,1.0,7,5,3,2,0
France - Ligue 2,Pau FC,1,2,7,15,9,1.15,1.56,9,10,7,5,3,1,1,2,9,4,1.18,1.12,7,5,3,1,1,0,1,5,6,5,1.12,2.0,2,5,4,4,2
France - Ligue 2,Red Star,1,2,5,17,9,1.09,1.5,8,11,7,6,2,0,2,2,9,4,1.12,1.29,5,6,2,4,0,1,0,3,8,5,1.06,1.71,3,5,5,2,2
France - Ligue 2,Rodez Aveyron,3,5,5,16,5,1.65,1.59,5,12,9,8,0,2,1,3,9,2,1.65,1.53,2,7,5,3,0,1,4,2,7,3,1.65,1.65,3,5,4,5,0
France - Ligue 2,SC Bastia,2,1,10,11,10,1.26,1.09,12,11,8,2,1,2,1,6,5,3,1.71,0.82,8,5,3,1,0,0,0,4,6,7,0.82,1.35,4,6,5,1,1
France - Ligue 2,Troyes,1,4,6,8,15,1.06,1.0,15,9,6,3,1,1,2,3,2,9,1.06,0.76,9,5,1,2,0,0,2,3,6,6,1.06,1.24,6,4,5,1,1
France - Ligue 2,USL Dunkerque,0,5,11,10,8,1.38,1.18,11,14,4,3,2,0,5,5,3,4,1.65,0.82,7,7,2,1,0,0,0,6,7,4,1.12,1.53,4,7,2,2,2
France - National,Aubagne,3,2,3,14,10,1.34,1.16,9,11,10,2,0,1,2,3,7,3,1.56,1.19,5,5,4,2,0,2,0,0,7,7,1.13,1.13,4,6,6,0,0
France - National,Boulogne,0,6,6,16,4,1.44,1.06,10,13,6,3,0,0,3,5,7,1,1.63,1.0,5,7,3,1,0,0,3,1,9,3,1.25,1.13,5,6,3,2,0
France - National,Bourg-en-Bresse,0,1,5,13,13,0.81,0.88,11,16,3,2,0,0,0,3,6,7,0.75,0.69,7,8,0,1,0,0,1,2,7,6,0.88,1.06,4,8,3,1,0
France - National,Chateauroux,1,2,10,10,9,1.25,1.94,6,8,9,5,4,1,2,5,6,2,1.63,1.69,5,2,6,2,1,0,0,5,4,7,0.88,2.19,1,6,3,3,3
France - National,Concarneau,3,4,4,14,7,1.5,1.44,6,12,9,4,1,3,1,2,8,2,1.81,1.13,3,8,5,0,0,0,3,2,6,5,1.19,1.75,3,4,4,4,1
France - National,Dijon,1,3,9,6,13,1.16,1.09,13,9,6,3,1,1,1,5,2,7,1.19,1.06,8,4,1,2,1,0,2,4,4,6,1.13,1.13,5,5,5,1,0
France - National,Le Mans,2,3,11,8,8,1.5,1.06,13,10,6,1,2,1,1,5,5,4,1.38,0.94,7,5,3,0,1,1,2,6,3,4,1.63,1.19,6,5,3,1,1
France - National,Nancy,4,3,8,12,5,1.69,0.88,15,7,9,1,0,1,2,3,8,2,1.5,0.69,9,3,4,0,0,3,1,5,4,3,1.88,1.06,6,4,5,1,0
France - National,Nimes,0,1,4,13,14,0.75,1.28,12,6,9,3,2,0,1,3,7,5,1.0,1.0,9,1,4,1,1,0,0,1,6,9,0.5,1.56,3,5,5,2,1
France - National,Orleans,2,3,8,10,9,1.34,1.28,8,14,5,4,1,2,2,3,8,1,1.75,1.56,3,7,2,3,1,0,1,5,2,8,0.94,1.0,5,7,3,1,0
France - National,Paris 13 A.,0,3,5,13,11,1.0,1.19,7,16,5,4,0,0,1,3,7,5,1.0,1.0,4,9,2,1,0,0,2,2,6,6,1.0,1.38,3,7,3,3,0
France - National,Quevilly Rouen,0,2,5,15,10,0.97,1.28,11,10,6,2,3,0,0,4,7,5,0.94,0.94,5,8,2,1,0,0,2,1,8,5,1.0,1.63,6,2,4,1,3
France - National,Rouen,2,2,9,10,9,1.31,1.22,8,12,10,1,1,2,1,6,2,5,1.56,1.19,6,4,4,1,1,0,1,3,8,4,1.06,1.25,2,8,6,0,0
France - National,Sochaux,0,1,7,12,12,0.91,0.94,10,17,3,1,1,0,0,6,4,6,1.0,0.88,6,7,2,1,0,0,1,1,8,6,0.81,1.0,4,10,1,0,1
France - National,Valenciennes,0,4,7,12,9,1.19,1.13,12,10,6,2,2,0,3,4,5,4,1.38,1.06,8,3,2,2,1,0,1,3,7,5,1.0,1.19,4,7,4,0,1
France - National,Versailles,0,6,7,9,10,1.28,1.38,8,12,5,6,1,0,2,4,8,2,1.38,1.25,5,6,1,4,0,0,4,3,1,8,1.19,1.5,3,6,4,2,1
France - National,Villefranche,1,0,7,11,13,0.91,1.16,7,15,8,2,0,0,0,4,6,6,0.88,1.13,4,8,2,2,0,1,0,3,5,7,0.94,1.19,3,7,6,0,0
Georgia - Erovnuli Liga,Dila Gori,2,2,6,4,4,1.78,0.89,6,9,2,1,0,2,0,4,1,2,2.11,1.0,2,6,0,1,0,0,2,2,3,2,1.44,0.78,4,3,2,0,0
Georgia - Erovnuli Liga,Dinamo Batumi,0,0,7,7,4,1.17,0.94,7,8,0,3,0,0,0,5,3,1,1.44,0.89,5,2,0,2,0,0,0,2,4,3,0.89,1.0,2,6,0,1,0
Georgia - Erovnuli Liga,Dinamo Tbilisi,1,1,5,6,5,1.28,0.83,6,9,3,0,0,0,1,4,3,0,1.75,0.75,3,4,1,0,0,1,0,1,3,5,0.9,0.9,3,5,2,0,0
Georgia - Erovnuli Liga,Gagra,0,1,2,10,5,0.94,1.22,6,5,5,1,1,0,1,0,5,4,0.8,1.3,2,5,2,0,1,0,0,2,5,1,1.13,1.13,4,0,3,1,0
Georgia - Erovnuli Liga,Gareji Sagarejo,1,0,2,9,6,0.94,1.06,4,10,3,1,0,1,0,1,3,4,1.0,0.89,2,6,1,0,0,0,0,1,6,2,0.89,1.22,2,4,2,1,0
Georgia - Erovnuli Liga,Iberia,1,2,6,7,2,1.61,0.56,10,6,2,0,0,1,1,4,3,0,2.0,0.44,5,4,0,0,0,0,1,2,4,2,1.22,0.67,5,2,2,0,0
Georgia - Erovnuli Liga,Kolkheti Poti,0,0,3,6,9,0.67,1.72,3,4,8,1,2,0,0,3,2,4,0.89,1.33,2,2,5,0,0,0,0,0,4,5,0.44,2.11,1,2,3,1,2
Georgia - Erovnuli Liga,Samgurali,1,4,1,5,7,1.44,1.22,5,6,6,0,1,1,2,0,0,6,1.44,0.67,4,4,1,0,0,0,2,1,5,1,1.44,1.78,1,2,5,0,1
Georgia - Erovnuli Liga,Telavi,0,0,2,8,8,0.67,2.06,4,4,4,4,2,0,0,1,6,2,0.89,1.44,3,2,1,3,0,0,0,1,2,6,0.44,2.67,1,2,3,1,2
Georgia - Erovnuli Liga,Torpedo Kutaisi,0,1,5,7,5,1.11,1.11,4,8,6,0,0,0,0,3,4,2,1.11,1.11,2,4,3,0,0,0,1,2,3,3,1.11,1.11,2,4,3,0,0
Germany - Bundesliga,Bayern Munich,11,11,5,6,1,2.91,0.94,16,8,6,4,0,6,6,4,1,0,3.12,0.94,9,2,4,2,0,5,5,1,5,1,2.71,0.94,7,6,2,2,0
Germany - Bundesliga,Bochum,0,2,8,11,13,0.97,1.97,6,9,8,6,5,0,1,3,7,6,0.94,1.94,3,5,3,3,3,0,1,5,4,7,1.0,2.0,3,4,5,3,2
Germany - Bundesliga,Dortmund,7,5,9,8,5,2.09,1.5,7,10,13,2,2,5,3,5,3,1,2.59,1.12,5,6,5,1,0,2,2,4,5,4,1.59,1.88,2,4,8,1,2
Germany - Bundesliga,E. Frankfurt,5,7,6,12,4,2.0,1.35,9,10,11,2,2,3,4,4,6,0,2.41,1.29,6,4,4,2,1,2,3,2,6,4,1.59,1.41,3,6,7,0,1
Germany - Bundesliga,FC Augsburg,0,2,9,11,12,1.03,1.5,11,9,5,5,4,0,1,5,5,6,1.06,1.18,6,5,3,3,0,0,1,4,6,6,1.0,1.82,5,4,2,2,4
Germany - Bundesliga,FSV Mainz,1,8,10,7,8,1.62,1.26,9,12,9,3,1,0,1,8,5,3,1.41,1.06,5,6,6,0,0,1,7,2,2,5,1.82,1.47,4,6,3,3,1
Germany - Bundesliga,Freiburg,1,7,5,13,8,1.44,1.56,11,7,8,3,5,1,6,2,5,3,1.88,1.53,4,4,6,2,1,0,1,3,8,5,1.0,1.59,7,3,2,1,4
Germany - Bundesliga,Heidenheim,1,3,8,8,14,1.09,1.88,9,6,6,7,6,1,1,1,4,10,0.76,1.94,4,3,3,4,3,0,2,7,4,4,1.41,1.82,5,3,3,3,3
Germany - Bundesliga,Hoffenheim,2,5,5,13,9,1.35,2.0,4,11,7,6,6,1,3,3,6,4,1.47,2.12,1,6,4,2,4,1,2,2,7,5,1.24,1.88,3,5,3,4,2
Germany - Bundesliga,Holstein Kiel,3,2,8,14,7,1.44,2.35,2,4,14,10,4,3,0,3,5,6,1.41,2.41,1,1,9,4,2,0,2,5,9,1,1.47,2.29,1,3,5,6,2
Germany - Bundesliga,Leverkusen,6,5,13,5,5,2.12,1.26,9,12,9,3,1,3,3,6,1,4,2.12,1.29,5,6,3,2,1,3,2,7,4,1,2.12,1.24,4,6,6,1,0
Germany - Bundesliga,Monchengladbach,4,4,7,13,6,1.62,1.68,7,11,6,7,3,3,2,2,7,3,1.71,1.53,4,6,2,4,1,1,2,5,6,3,1.53,1.82,3,5,4,3,2
Germany - Bundesliga,RB Leipzig,2,7,8,8,9,1.56,1.41,14,5,8,3,4,2,3,6,4,2,1.94,1.35,6,4,4,2,1,0,4,2,4,7,1.18,1.47,8,1,4,1,3
Germany - Bundesliga,Sankt Pauli,0,3,5,9,17,0.82,1.21,9,12,10,3,0,0,2,0,4,11,0.59,1.12,4,8,4,1,0,0,1,5,5,6,1.06,1.29,5,4,6,2,0
Germany - Bundesliga,Stuttgart,5,6,8,9,6,1.88,1.56,7,11,9,4,3,3,3,4,5,2,2.06,1.59,3,6,4,3,1,2,3,4,4,4,1.71,1.53,4,5,5,1,2
Germany - Bundesliga,Union Berlin,2,0,9,9,14,1.03,1.5,8,13,6,4,3,1,0,4,6,6,1.06,1.35,4,6,5,1,1,1,0,5,3,8,1.0,1.65,4,7,1,3,2
Germany - Bundesliga,Werder Bremen,4,2,13,6,9,1.59,1.68,10,7,8,4,5,1,1,5,4,6,1.24,1.53,6,3,4,2,2,3,1,8,2,3,1.94,1.82,4,4,4,2,3
Germany - Bundesliga,Wolfsburg,3,3,12,9,7,1.65,1.59,6,14,5,6,3,2,0,6,6,3,1.59,1.76,2,6,4,4,1,1,3,6,3,4,1.71,1.41,4,8,1,2,2
Germany - 2. Bundesliga,Bielefeld,0,0,0,0,0,,,0,0,0,0,0,0,0,0,0,0,,,0,0,0,0,0,0,0,0,0,0,,,0,0,0,0,0
Germany - 2. Bundesliga,Bochum,0,0,0,0,0,,,0,0,0,0,0,0,0,0,0,0,,,0,0,0,0,0,0,0,0,0,0,,,0,0,0,0,0
Germany - 2. Bundesliga,Braunschweig,0,0,0,0,0,,,0,0,0,0,0,0,0,0,0,0,,,0,0,0,0,0,0,0,0,0,0,,,0,0,0,0,0
Germany - 2. Bundesliga,Darmstadt,0,0,0,0,0,,,0,0,0,0,0,0,0,0,0,0,,,0,0,0,0,0,0,0,0,0,0,,,0,0,0,0,0
Germany - 2. Bundesliga,Dusseldorf,0,0,0,0,0,,,0,0,0,0,0,0,0,0,0,0,,,0,0,0,0,0,0,0,0,0,0,,,0,0,0,0,0
Germany - 2. Bundesliga,Dynamo Dresden,0,0,0,0,0,,,0,0,0,0,0,0,0,0,0,0,,,0,0,0,0,0,0,0,0,0,0,,,0,0,0,0,0
Germany - 2. Bundesliga,Elversberg,0,0,0,0,0,,,0,0,0,0,0,0,0,0,0,0,,,0,0,0,0,0,0,0,0,0,0,,,0,0,0,0,0
Germany - 2. Bundesliga,FC Nurnberg,0,0,0,0,0,,,0,0,0,0,0,0,0,0,0,0,,,0,0,0,0,0,0,0,0,0,0,,,0,0,0,0,0
Germany - 2. Bundesliga,Greuther Furth,0,0,0,0,0,,,0,0,0,0,0,0,0,0,0,0,,,0,0,0,0,0,0,0,0,0,0,,,0,0,0,0,0
Germany - 2. Bundesliga,Hannover 96,0,0,0,0,0,,,0,0,0,0,0,0,0,0,0,0,,,0,0,0,0,0,0,0,0,0,0,,,0,0,0,0,0
Germany - 2. Bundesliga,Hertha Berlin,0,0,0,0,0,,,0,0,0,0,0,0,0,0,0,0,,,0,0,0,0,0,0,0,0,0,0,,,0,0,0,0,0
Germany - 2. Bundesliga,Holstein Kiel,0,0,0,0,0,,,0,0,0,0,0,0,0,0,0,0,,,0,0,0,0,0,0,0,0,0,0,,,0,0,0,0,0
Germany - 2. Bundesliga,Kaiserslautern,0,0,0,0,0,,,0,0,0,0,0,0,0,0,0,0,,,0,0,0,0,0,0,0,0,0,0,,,0,0,0,0,0
Germany - 2. Bundesliga,Karlsruher SC,0,0,0,0,0,,,0,0,0,0,0,0,0,0,0,0,,,0,0,0,0,0,0,0,0,0,0,,,0,0,0,0,0
Germany - 2. Bundesliga,Magdeburg,0,0,0,0,0,,,0,0,0,0,0,0,0,0,0,0,,,0,0,0,0,0,0,0,0,0,0,,,0,0,0,0,0
Germany - 2. Bundesliga,Paderborn,0,0,0,0,0,,,0,0,0,0,0,0,0,0,0,0,,,0,0,0,0,0,0,0,0,0,0,,,0,0,0,0,0
Germany - 2. Bundesliga,Preuss. Munster,0,0,0,0,0,,,0,0,0,0,0,0,0,0,0,0,,,0,0,0,0,0,0,0,0,0,0,,,0,0,0,0,0
Germany - 2. Bundesliga,Schalke 04,0,0,0,0,0,,,0,0,0,0,0,0,0,0,0,0,,,0,0,0,0,0,0,0,0,0,0,,,0,0,0,0,0
Germany - 3. Liga,1860 Munchen,0,0,0,0,0,,,0,0,0,0,0,0,0,0,0,0,,,0,0,0,0,0,0,0,0,0,0,,,0,0,0,0,0
Germany - 3. Liga,Alemannia A.,0,0,0,0,0,,,0,0,0,0,0,0,0,0,0,0,,,0,0,0,0,0,0,0,0,0,0,,,0,0,0,0,0
Germany - 3. Liga,Energie Cottbus,0,0,0,0,0,,,0,0,0,0,0,0,0,0,0,0,,,0,0,0,0,0,0,0,0,0,0,,,0,0,0,0,0
Germany - 3. Liga,Erzgebirge Aue,0,0,0,0,0,,,0,0,0,0,0,0,0,0,0,0,,,0,0,0,0,0,0,0,0,0,0,,,0,0,0,0,0
Germany - 3. Liga,FC Ingolstadt,0,0,0,0,0,,,0,0,0,0,0,0,0,0,0,0,,,0,0,0,0,0,0,0,0,0,0,,,0,0,0,0,0
Germany - 3. Liga,Hansa Rostock,0,0,0,0,0,,,0,0,0,0,0,0,0,0,0,0,,,0,0,0,0,0,0,0,0,0,0,,,0,0,0,0,0
Germany - 3. Liga,Havelse,0,0,0,0,0,,,0,0,0,0,0,0,0,0,0,0,,,0,0,0,0,0,0,0,0,0,0,,,0,0,0,0,0
Germany - 3. Liga,Hoffenheim B,0,0,0,0,0,,,0,0,0,0,0,0,0,0,0,0,,,0,0,0,0,0,0,0,0,0,0,,,0,0,0,0,0
Germany - 3. Liga,MSV Duisburg,0,0,0,0,0,,,0,0,0,0,0,0,0,0,0,0,,,0,0,0,0,0,0,0,0,0,0,,,0,0,0,0,0
Germany - 3. Liga,Mannheim,0,0,0,0,0,,,0,0,0,0,0,0,0,0,0,0,,,0,0,0,0,0,0,0,0,0,0,,,0,0,0,0,0
Germany - 3. Liga,Osnabruck,0,0,0,0,0,,,0,0,0,0,0,0,0,0,0,0,,,0,0,0,0,0,0,0,0,0,0,,,0,0,0,0,0
Germany - 3. Liga,RW Essen,0,0,0,0,0,,,0,0,0,0,0,0,0,0,0,0,,,0,0,0,0,0,0,0,0,0,0,,,0,0,0,0,0
Germany - 3. Liga,Regensburg,0,0,0,0,0,,,0,0,0,0,0,0,0,0,0,0,,,0,0,0,0,0,0,0,0,0,0,,,0,0,0,0,0
Germany - 3. Liga,Saarbrucken,0,0,0,0,0,,,0,0,0,0,0,0,0,0,0,0,,,0,0,0,0,0,0,0,0,0,0,,,0,0,0,0,0
Germany - 3. Liga,Schweinfurt,0,0,0,0,0,,,0,0,0,0,0,0,0,0,0,0,,,0,0,0,0,0,0,0,0,0,0,,,0,0,0,0,0
Germany - 3. Liga,Ulm,0,0,0,0,0,,,0,0,0,0,0,0,0,0,0,0,,,0,0,0,0,0,0,0,0,0,0,,,0,0,0,0,0
Germany - 3. Liga,Verl,0,0,0,0,0,,,0,0,0,0,0,0,0,0,0,0,,,0,0,0,0,0,0,0,0,0,0,,,0,0,0,0,0
Germany - 3. Liga,VfB Stuttgart B,0,0,0,0,0,,,0,0,0,0,0,0,0,0,0,0,,,0,0,0,0,0,0,0,0,0,0,,,0,0,0,0,0
Germany - 3. Liga,Viktoria Koln,0,0,0,0,0,,,0,0,0,0,0,0,0,0,0,0,,,0,0,0,0,0,0,0,0,0,0,,,0,0,0,0,0
Germany - 3. Liga,Wehen Wiesbaden,0,0,0,0,0,,,0,0,0,0,0,0,0,0,0,0,,,0,0,0,0,0,0,0,0,0,0,,,0,0,0,0,0
Greece - Super League,A. Kallithea,0,1,10,13,12,1.0,1.44,9,11,9,5,2,0,1,5,7,5,1.11,1.5,4,7,2,4,1,0,0,5,6,7,0.89,1.39,5,4,7,1,1
Greece - Super League,AEK Athens,3,4,7,9,9,1.5,0.88,14,12,3,2,1,2,2,5,5,2,1.88,0.75,8,5,2,1,0,1,2,2,4,7,1.13,1.0,6,7,1,1,1
Greece - Super League,Aris,0,1,8,12,5,1.19,1.08,10,9,4,1,2,0,1,6,2,4,1.31,0.62,6,6,1,0,0,0,0,2,10,1,1.08,1.54,4,3,3,1,2
Greece - Super League,Asteras T.,0,2,3,15,6,1.04,1.12,8,9,7,2,0,0,1,2,7,3,1.08,1.0,5,4,3,1,0,0,1,1,8,3,1.0,1.23,3,5,4,1,0
Greece - Super League,Atromitos,1,3,3,13,6,1.23,1.23,6,9,10,1,0,1,0,1,7,4,1.0,1.31,2,5,6,0,0,0,3,2,6,2,1.46,1.15,4,4,4,1,0
Greece - Super League,Lamia,0,1,4,10,21,0.58,1.78,6,11,9,8,2,0,1,2,6,9,0.72,1.67,3,5,5,5,0,0,0,2,4,12,0.44,1.89,3,6,4,3,2
Greece - Super League,Levadiakos,3,5,6,11,11,1.39,1.19,9,13,12,2,0,2,3,1,6,6,1.39,1.28,4,6,7,1,0,1,2,5,5,5,1.39,1.11,5,7,5,1,0
Greece - Super League,OFI Crete,1,6,5,5,9,1.42,1.46,5,10,7,3,1,1,3,2,3,4,1.54,1.54,3,3,6,0,1,0,3,3,2,5,1.31,1.38,2,7,1,3,0
Greece - Super League,Olympiakos,4,3,11,11,3,1.81,0.69,16,10,6,0,0,3,1,6,5,1,2.0,0.81,6,7,3,0,0,1,2,5,6,2,1.63,0.56,10,3,3,0,0
Greece - Super League,PAOK,4,3,11,11,3,1.94,1.16,11,9,9,2,1,1,2,6,5,2,1.88,1.0,7,3,5,1,0,3,1,5,6,1,2.0,1.31,4,6,4,1,1
Greece - Super League,Panaitolikos,0,2,5,13,16,0.81,0.86,14,14,7,1,0,0,1,2,7,8,0.78,0.89,7,7,3,1,0,0,1,3,6,8,0.83,0.83,7,7,4,0,0
Greece - Super League,Panathinaikos,0,4,8,14,6,1.31,1.0,11,13,6,1,1,0,4,3,6,3,1.5,0.69,6,9,1,0,0,0,0,5,8,3,1.13,1.31,5,4,5,1,1
Greece - Super League,Panserraikos,0,2,12,10,12,1.11,1.69,5,16,4,8,3,0,2,7,5,4,1.39,1.44,4,8,2,2,2,0,0,5,5,8,0.83,1.94,1,8,2,6,1
Greece - Super League,Volos,0,4,6,12,14,1.0,1.44,9,13,6,5,3,0,2,2,6,8,0.89,1.33,5,7,3,1,2,0,2,4,6,6,1.11,1.56,4,6,3,4,1
Guatemala - Liga Nacional - Apertura,Achuapa,0,0,1,0,0,2.0,2.0,0,0,1,0,0,0,0,1,0,0,2.0,2.0,0,0,1,0,0,0,0,0,0,0,,,0,0,0,0,0
Guatemala - Liga Nacional - Apertura,Antigua GFC,0,1,0,0,0,3.0,0.0,1,0,0,0,0,0,1,0,0,0,3.0,0.0,1,0,0,0,0,0,0,0,0,0,,,0,0,0,0,0
Guatemala - Liga Nacional - Apertura,Aurora,0,0,0,1,0,1.0,0.0,1,0,0,0,0,0,0,0,1,0,1.0,0.0,1,0,0,0,0,0,0,0,0,0,,,0,0,0,0,0
Guatemala - Liga Nacional - Apertura,Coban Imperial,0,0,0,0,1,0.0,1.0,0,1,0,0,0,0,0,0,0,1,0.0,1.0,0,1,0,0,0,0,0,0,0,0,,,0,0,0,0,0
Guatemala - Liga Nacional - Apertura,Comunicaciones,0,0,1,0,0,2.0,0.0,1,0,0,0,0,0,0,1,0,0,2.0,0.0,1,0,0,0,0,0,0,0,0,0,,,0,0,0,0,0
Guatemala - Liga Nacional - Apertura,Guastatoya,0,0,0,0,1,0.0,1.0,0,1,0,0,0,0,0,0,0,0,,,0,0,0,0,0,0,0,0,0,1,0.0,1.0,0,1,0,0,0
Guatemala - Liga Nacional - Apertura,Malacateco,0,0,0,0,1,0.0,1.0,0,1,0,0,0,0,0,0,0,1,0.0,1.0,0,1,0,0,0,0,0,0,0,0,,,0,0,0,0,0
Guatemala - Liga Nacional - Apertura,Marquense,0,0,0,0,1,0.0,3.0,0,0,0,1,0,0,0,0,0,0,,,0,0,0,0,0,0,0,0,0,1,0.0,3.0,0,0,0,1,0
Guatemala - Liga Nacional - Apertura,Mictlan,0,0,0,0,1,0.0,2.0,0,0,1,0,0,0,0,0,0,0,,,0,0,0,0,0,0,0,0,0,1,0.0,2.0,0,0,1,0,0
Guatemala - Liga Nacional - Apertura,Mixco,0,0,0,1,0,1.0,0.0,1,0,0,0,0,0,0,0,0,0,,,0,0,0,0,0,0,0,0,1,0,1.0,0.0,1,0,0,0,0
Guatemala - Liga Nacional - Apertura,Municipal,0,0,1,0,0,2.0,2.0,0,0,1,0,0,0,0,0,0,0,,,0,0,0,0,0,0,0,1,0,0,2.0,2.0,0,0,1,0,0
Guatemala - Liga Nacional - Apertura,Xelaju,0,0,0,1,0,1.0,0.0,1,0,0,0,0,0,0,0,0,0,,,0,0,0,0,0,0,0,0,1,0,1.0,0.0,1,0,0,0,0
Guatemala - Liga Nacional - Clausura,Achuapa,0,1,4,7,8,0.9,1.15,6,6,7,1,0,0,0,3,4,3,1.0,0.7,5,3,2,0,0,0,1,1,3,5,0.8,1.6,1,3,5,1,0
Guatemala - Liga Nacional - Clausura,Antigua GFC,1,2,5,8,4,1.5,1.2,7,7,3,2,1,1,1,4,4,0,2.1,1.0,4,4,0,2,0,0,1,1,4,4,0.9,1.4,3,3,3,0,1
Guatemala - Liga Nacional - Clausura,Coban Imperial,0,3,6,5,6,1.3,1.25,8,4,5,1,2,0,2,3,2,3,1.4,0.4,7,2,1,0,0,0,1,3,3,3,1.2,2.1,1,2,4,1,2
Guatemala - Liga Nacional - Clausura,Comunicaciones,0,1,8,8,3,1.35,1.2,5,9,3,3,0,0,1,5,4,0,1.7,1.3,2,5,1,2,0,0,0,3,4,3,1.0,1.1,3,4,2,1,0
Guatemala - Liga Nacional - Clausura,Guastatoya,1,1,3,8,7,1.05,1.1,8,6,4,1,1,1,0,1,6,2,1.2,0.7,6,1,3,0,0,0,1,2,2,5,0.9,1.5,2,5,1,1,1
Guatemala - Liga Nacional - Clausura,Malacateco,2,1,5,8,4,1.5,1.3,4,8,7,0,1,2,0,4,3,1,2.0,0.9,3,5,2,0,0,0,1,1,5,3,1.0,1.7,1,3,5,0,1
Guatemala - Liga Nacional - Clausura,Marquense,0,2,4,4,10,0.9,0.95,8,7,3,2,0,0,0,4,3,3,1.1,0.7,6,2,1,1,0,0,2,0,1,7,0.7,1.2,2,5,2,1,0
Guatemala - Liga Nacional - Clausura,Mixco,0,1,4,10,5,1.05,1.15,4,11,3,2,0,0,1,3,4,2,1.3,1.1,3,5,0,2,0,0,0,1,6,3,0.8,1.2,1,6,3,0,0
Guatemala - Liga Nacional - Clausura,Municipal,1,0,6,10,3,1.3,0.9,7,8,5,0,0,1,0,4,4,1,1.6,0.9,3,5,2,0,0,0,0,2,6,2,1.0,0.9,4,3,3,0,0
Guatemala - Liga Nacional - Clausura,Xelaju,2,1,4,5,8,1.4,1.25,4,8,7,1,0,2,1,2,3,2,2.2,1.1,3,4,2,1,0,0,0,2,2,6,0.6,1.4,1,4,5,0,0
Guatemala - Liga Nacional - Clausura,Xinabajul,0,1,5,8,6,1.05,1.85,3,7,7,1,2,0,0,3,4,3,1.0,1.2,2,4,4,0,0,0,1,2,4,3,1.1,2.5,1,3,3,1,2
Hong Kong - Premier League,Eastern,4,5,7,7,1,2.25,1.04,7,13,1,2,1,2,3,4,3,0,2.42,1.17,3,7,0,1,1,2,2,3,4,1,2.08,0.92,4,6,1,1,0
Hong Kong - Premier League,HK Rangers,2,5,4,6,7,1.58,2.21,3,6,7,4,4,0,2,3,5,2,1.42,2.0,2,3,3,2,2,2,3,1,1,5,1.75,2.42,1,3,4,2,2
Hong Kong - Premier League,Hong Kong FC,0,2,2,11,9,0.88,2.46,4,2,4,8,6,0,1,2,4,5,0.92,2.08,4,0,2,3,3,0,1,0,7,4,0.83,2.83,0,2,2,5,3
Hong Kong - Premier League,Kitchee,5,4,4,7,4,2.29,1.04,6,14,2,1,1,4,2,1,3,2,2.83,0.92,4,6,1,1,0,1,2,3,4,2,1.75,1.17,2,8,1,0,1
Hong Kong - Premier League,Kowloon City,1,3,6,10,4,1.5,2.71,4,2,5,6,7,1,1,3,4,3,1.5,3.0,1,2,2,2,5,0,2,3,6,1,1.5,2.42,3,0,3,4,2
Hong Kong - Premier League,LM Warriors,5,6,5,6,2,2.25,1.38,6,11,3,3,1,3,5,2,2,0,2.75,1.67,2,6,2,1,1,2,1,3,4,2,1.75,1.08,4,5,1,2,0
Hong Kong - Premier League,North District,2,4,5,7,6,1.54,2.71,0,5,5,8,6,1,3,4,1,3,1.83,2.25,0,4,2,5,1,1,1,1,6,3,1.25,3.17,0,1,3,3,5
Hong Kong - Premier League,Southern D.,2,2,5,10,5,1.42,1.46,3,10,8,3,0,1,1,2,5,3,1.33,1.25,2,6,3,1,0,1,1,3,5,2,1.5,1.67,1,4,5,2,0
Hong Kong - Premier League,Tai Po,5,7,4,7,1,2.58,1.29,6,8,7,3,0,1,3,3,5,0,2.08,1.17,3,5,3,1,0,4,4,1,2,1,3.08,1.42,3,3,4,2,0
Hungary - NB I,DVTK,0,0,0,0,0,,,0,0,0,0,0,0,0,0,0,0,,,0,0,0,0,0,0,0,0,0,0,,,0,0,0,0,0
Hungary - NB I,Debrecen,0,0,0,0,0,,,0,0,0,0,0,0,0,0,0,0,,,0,0,0,0,0,0,0,0,0,0,,,0,0,0,0,0
Hungary - NB I,Ferencvaros,0,0,0,0,0,,,0,0,0,0,0,0,0,0,0,0,,,0,0,0,0,0,0,0,0,0,0,,,0,0,0,0,0
Hungary - NB I,Gyor,0,0,0,0,0,,,0,0,0,0,0,0,0,0,0,0,,,0,0,0,0,0,0,0,0,0,0,,,0,0,0,0,0
Hungary - NB I,Kazincbarcika,0,0,0,0,0,,,0,0,0,0,0,0,0,0,0,0,,,0,0,0,0,0,0,0,0,0,0,,,0,0,0,0,0
Hungary - NB I,Kisvarda,0,0,0,0,0,,,0,0,0,0,0,0,0,0,0,0,,,0,0,0,0,0,0,0,0,0,0,,,0,0,0,0,0
Hungary - NB I,MTK Budapest,0,0,0,0,0,,,0,0,0,0,0,0,0,0,0,0,,,0,0,0,0,0,0,0,0,0,0,,,0,0,0,0,0
Hungary - NB I,Nyiregyhaza,0,0,0,0,0,,,0,0,0,0,0,0,0,0,0,0,,,0,0,0,0,0,0,0,0,0,0,,,0,0,0,0,0
Hungary - NB I,Paks,0,0,0,0,0,,,0,0,0,0,0,0,0,0,0,0,,,0,0,0,0,0,0,0,0,0,0,,,0,0,0,0,0
Hungary - NB I,Puskas A.,0,0,0,0,0,,,0,0,0,0,0,0,0,0,0,0,,,0,0,0,0,0,0,0,0,0,0,,,0,0,0,0,0
Hungary - NB I,Ujpest,0,0,0,0,0,,,0,0,0,0,0,0,0,0,0,0,,,0,0,0,0,0,0,0,0,0,0,,,0,0,0,0,0
Hungary - NB I,Zalaegerszegi,0,0,0,0,0,,,0,0,0,0,0,0,0,0,0,0,,,0,0,0,0,0,0,0,0,0,0,,,0,0,0,0,0
Iceland - Urvalsdeild,Afturelding,2,1,2,3,7,1.2,1.33,4,4,5,2,0,2,1,1,2,2,1.88,1.13,3,2,2,1,0,0,0,1,1,5,0.43,1.57,1,2,3,1,0
Iceland - Urvalsdeild,Breidablik,1,2,6,5,1,1.8,1.33,5,5,2,1,2,0,2,3,3,0,1.88,1.38,2,4,0,1,1,1,0,3,2,1,1.71,1.29,3,1,2,0,1
Iceland - Urvalsdeild,Fram,1,2,3,7,2,1.53,1.27,5,3,5,2,0,1,1,2,2,1,1.86,0.71,4,1,2,0,0,0,1,1,5,1,1.25,1.75,1,2,3,2,0
Iceland - Urvalsdeild,Hafnarfjordur,1,2,5,4,3,1.67,1.33,5,3,4,3,0,1,1,3,1,1,2.14,0.43,5,1,1,0,0,0,1,2,3,2,1.25,2.13,0,2,3,3,0
Iceland - Urvalsdeild,IA Akranes,1,1,1,7,5,1.07,2.13,4,2,3,3,3,0,1,0,2,4,0.71,1.71,2,1,1,3,0,1,0,1,5,1,1.38,2.5,2,1,2,0,3
Iceland - Urvalsdeild,IBV,0,3,1,3,8,0.93,1.4,5,2,6,1,1,0,1,1,2,4,0.88,1.0,3,2,3,0,0,0,2,0,1,4,1.0,1.86,2,0,3,1,1
Iceland - Urvalsdeild,KA Akureyri,0,1,4,3,7,0.93,2.07,2,5,3,2,3,0,1,2,2,2,1.29,1.86,1,2,3,0,1,0,0,2,1,5,0.63,2.25,1,3,0,2,2
Iceland - Urvalsdeild,KR Reykjavik,2,4,6,2,1,2.33,2.47,1,3,4,4,3,2,2,2,1,0,2.86,1.71,1,2,2,2,0,0,2,4,1,1,1.88,3.13,0,1,2,2,3
Iceland - Urvalsdeild,Stjarnan,1,2,5,5,2,1.67,1.73,2,5,4,3,1,1,1,5,1,0,2.25,1.88,1,2,3,1,1,0,1,0,4,2,1.0,1.57,1,3,1,2,0
Iceland - Urvalsdeild,Valur,3,3,5,3,1,2.6,1.33,3,7,2,3,0,2,2,1,2,0,3.14,0.86,1,6,0,0,0,1,1,4,1,1,2.13,1.75,2,1,2,3,0
Iceland - Urvalsdeild,Vestri,0,1,3,4,7,0.87,0.93,5,6,4,0,0,0,1,1,2,4,0.88,0.88,3,3,2,0,0,0,0,2,2,3,0.86,1.0,2,3,2,0,0
Iceland - Urvalsdeild,Vikingur R.,1,3,5,4,2,1.8,1.07,5,5,4,1,0,1,3,3,1,0,2.5,1.13,2,3,3,0,0,0,0,2,3,2,1.0,1.0,3,2,1,1,0
Iceland - 1. Deild,Fjolnir,2,1,1,5,4,1.38,2.46,1,3,2,5,2,0,0,1,2,3,0.67,2.83,0,1,1,3,1,2,1,0,3,1,2.0,2.14,1,2,1,2,1
Iceland - 1. Deild,Fylkir,1,0,1,10,1,1.23,1.62,1,6,4,1,1,0,0,1,5,1,1.0,1.43,1,2,4,0,0,1,0,0,5,0,1.5,1.83,0,4,0,1,1
Iceland - 1. Deild,Grindavik,2,3,2,4,1,2.25,2.83,0,2,5,1,4,0,2,2,1,1,1.83,3.17,0,1,1,1,3,2,1,0,3,0,2.67,2.5,0,1,4,0,1
Iceland - 1. Deild,HK Kopavogur,1,3,3,6,0,1.92,1.15,3,6,3,1,0,1,2,0,3,0,2.17,1.33,1,3,1,1,0,0,1,3,3,0,1.71,1.0,2,3,2,0,0
Iceland - 1. Deild,IR Reykjavik,1,2,3,6,1,1.85,0.77,5,6,2,0,0,1,0,2,3,0,2.17,0.67,3,2,1,0,0,0,2,1,3,1,1.57,0.86,2,4,1,0,0
Iceland - 1. Deild,Keflavik,3,2,1,3,3,2.17,1.75,2,4,2,3,1,2,1,0,1,3,2.14,1.57,2,2,1,1,1,1,1,1,2,0,2.2,2.0,0,2,1,2,0
Iceland - 1. Deild,Leiknir R.,0,1,3,4,5,1.0,2.15,0,8,2,0,3,0,1,1,3,2,1.14,2.14,0,5,0,0,2,0,0,2,1,3,0.83,2.17,0,3,2,0,1
Iceland - 1. Deild,Njardvik,3,3,1,6,0,2.38,0.92,2,10,1,0,0,1,2,0,3,0,2.33,1.0,0,6,0,0,0,2,1,1,3,0,2.43,0.86,2,4,1,0,0
Iceland - 1. Deild,Selfoss,0,1,5,2,5,1.15,1.92,2,2,6,1,2,0,1,2,1,2,1.33,2.0,0,2,3,0,1,0,0,3,1,3,1.0,1.86,2,0,3,1,1
Iceland - 1. Deild,Thor Akureyri,4,0,4,6,0,2.21,1.64,3,5,1,4,1,1,0,3,4,0,1.75,1.5,2,3,1,1,1,3,0,1,2,0,2.83,1.83,1,2,0,3,0
Iceland - 1. Deild,Throttur R.,1,1,6,5,0,1.85,1.62,2,5,4,0,2,1,1,3,2,0,2.14,2.29,0,2,3,0,2,0,0,3,3,0,1.5,0.83,2,3,1,0,0
Iceland - 1. Deild,Volsungur,1,2,3,7,1,1.64,2.21,0,7,1,3,3,0,1,2,3,0,1.67,1.83,0,4,0,1,1,1,1,1,4,1,1.63,2.5,0,3,1,2,2
Ireland - Premier Division,Bohemians,1,3,4,9,7,1.25,0.92,10,7,6,1,0,1,1,2,6,2,1.42,0.75,6,3,3,0,0,0,2,2,3,5,1.08,1.08,4,4,3,1,0
Ireland - Premier Division,Cork City,0,0,5,14,5,1.0,1.79,1,10,8,3,2,0,0,3,6,3,1.0,1.25,1,7,4,0,0,0,0,2,8,2,1.0,2.33,0,3,4,3,2
Ireland - Premier Division,Derry City,1,3,3,13,4,1.46,1.08,9,6,7,2,0,1,2,2,7,0,2.0,1.0,5,3,3,1,0,0,1,1,6,4,0.92,1.17,4,3,4,1,0
Ireland - Premier Division,Drogheda Utd,0,3,4,12,6,1.16,1.0,11,5,7,2,0,0,2,2,7,1,1.42,0.83,6,2,4,0,0,0,1,2,5,5,0.92,1.15,5,3,3,2,0
Ireland - Premier Division,Galway Utd,0,1,8,8,7,1.13,1.25,3,14,5,2,0,0,1,4,4,2,1.36,1.18,1,8,1,1,0,0,0,4,4,5,0.92,1.31,2,6,4,1,0
Ireland - Premier Division,Shamrock Rovers,3,2,10,6,4,1.76,0.92,9,10,5,1,0,3,1,4,2,2,2.08,0.58,8,2,1,1,0,0,1,6,4,2,1.46,1.23,1,8,4,0,0
Ireland - Premier Division,Shelbourne,0,3,6,9,7,1.2,1.08,5,13,7,0,0,0,3,2,4,4,1.31,1.08,2,8,3,0,0,0,0,4,5,3,1.08,1.08,3,5,4,0,0
Ireland - Premier Division,Sligo Rovers,1,1,8,7,7,1.25,1.63,4,9,5,4,2,0,0,6,4,3,1.23,1.31,2,6,4,1,0,1,1,2,3,4,1.27,2.0,2,3,1,3,2
Ireland - Premier Division,St. Patricks,1,2,6,5,11,1.08,1.08,11,5,6,2,1,1,2,4,0,6,1.38,0.85,7,2,3,1,0,0,0,2,5,5,0.75,1.33,4,3,3,1,1
Ireland - Premier Division,Waterford,0,1,10,5,8,1.17,1.75,3,9,8,2,2,0,0,6,3,3,1.25,1.67,2,4,3,2,1,0,1,4,2,5,1.08,1.83,1,5,5,0,1
Ireland - First Division,Athlone Town,0,0,5,6,12,0.7,1.61,5,8,4,4,2,0,0,3,2,6,0.73,1.73,2,5,1,1,2,0,0,2,4,6,0.67,1.5,3,3,3,3,0
Ireland - First Division,Bray Wanderers,3,2,5,11,2,1.7,1.26,9,4,7,2,1,2,2,4,4,0,2.17,1.17,4,4,2,2,0,1,0,1,7,2,1.18,1.36,5,0,5,0,1
Ireland - First Division,Cobh Ramblers,1,4,7,8,3,1.7,0.96,8,9,5,1,0,1,1,4,4,1,1.82,0.82,5,4,1,1,0,0,3,3,4,2,1.58,1.08,3,5,4,0,0
Ireland - First Division,Dundalk,1,4,5,10,3,1.57,0.7,11,8,4,0,0,0,1,4,6,0,1.55,0.73,5,4,2,0,0,1,3,1,4,3,1.58,0.67,6,4,2,0,0
Ireland - First Division,Finn Harps,2,0,1,13,6,1.09,1.32,7,5,6,4,0,2,0,0,5,4,1.27,1.18,3,3,5,0,0,0,0,1,8,2,0.91,1.45,4,2,1,4,0
Ireland - First Division,Kerry,0,2,7,4,9,1.09,1.73,5,7,3,3,4,0,1,2,2,5,0.9,1.1,3,5,1,0,1,0,1,5,2,4,1.25,2.25,2,2,2,3,3
Ireland - First Division,Longford Town,0,3,2,9,9,0.96,1.7,4,9,5,2,3,0,3,2,2,5,1.25,1.25,2,6,3,1,0,0,0,0,7,4,0.64,2.18,2,3,2,1,3
Ireland - First Division,Treaty Utd,3,2,5,6,7,1.57,1.0,7,10,5,1,0,2,2,3,2,3,1.92,0.83,4,7,0,1,0,1,0,2,4,4,1.18,1.18,3,3,5,0,0
Ireland - First Division,UC Dublin,0,2,3,9,9,0.91,1.13,6,12,2,2,1,0,1,1,4,6,0.75,1.17,2,8,0,2,0,0,1,2,5,3,1.09,1.09,4,4,2,0,1
Ireland - First Division,Wexford,1,3,5,6,8,1.26,1.17,6,10,4,3,0,1,1,4,1,5,1.33,1.33,3,4,3,2,0,0,2,1,5,3,1.18,1.0,3,6,1,1,0
Indonesia - Liga 1,Arema,3,5,6,12,8,1.56,1.5,6,11,11,6,0,2,3,1,6,5,1.59,1.47,3,5,7,2,0,1,2,5,6,3,1.53,1.53,3,6,4,4,0
Indonesia - Liga 1,Bali Utd,3,6,4,11,10,1.47,1.21,9,12,10,3,0,1,4,2,5,5,1.47,0.94,7,5,4,1,0,2,2,2,6,5,1.47,1.47,2,7,6,2,0
Indonesia - Liga 1,Barito Putera,1,2,9,14,8,1.24,1.68,5,12,8,7,2,0,2,3,7,5,1.12,1.65,3,6,3,4,1,1,0,6,7,3,1.35,1.71,2,6,5,3,1
Indonesia - Liga 1,Borneo,2,4,8,12,8,1.47,1.12,11,14,4,4,1,1,2,3,7,4,1.41,0.82,9,5,1,1,1,1,2,5,5,4,1.53,1.41,2,9,3,3,0
Indonesia - Liga 1,Dewa Utd,5,3,10,10,6,1.91,0.97,14,12,3,5,0,2,3,8,3,1,2.24,1.0,7,5,3,2,0,3,0,2,7,5,1.59,0.94,7,7,0,3,0
Indonesia - Liga 1,Madura Utd,0,2,10,10,12,1.06,1.71,8,11,5,4,6,0,1,8,4,4,1.35,1.59,4,6,2,3,2,0,1,2,6,8,0.76,1.82,4,5,3,1,4
Indonesia - Liga 1,Malut United,1,5,8,12,8,1.41,0.97,10,19,2,2,1,1,2,5,5,4,1.53,0.88,6,9,1,0,1,0,3,3,7,4,1.29,1.06,4,10,1,2,0
Indonesia - Liga 1,PSBS Biak N.,0,4,9,14,7,1.29,1.38,8,14,5,5,2,0,3,5,7,2,1.53,1.47,2,8,4,3,0,0,1,4,7,5,1.06,1.29,6,6,1,2,2
Indonesia - Liga 1,PSIS Semarang,0,1,4,18,11,0.85,1.68,8,7,13,2,4,0,0,2,10,5,0.82,1.71,3,5,6,1,2,0,1,2,8,6,0.88,1.65,5,2,7,1,2
Indonesia - Liga 1,PSM,1,5,6,16,6,1.38,1.0,9,18,5,2,0,0,4,2,6,5,1.29,0.65,8,7,2,0,0,1,1,4,10,1,1.47,1.35,1,11,3,2,0
Indonesia - Liga 1,PSS Sleman,1,5,7,10,11,1.26,1.47,6,16,7,2,3,1,3,3,6,4,1.47,1.59,1,9,5,0,2,0,2,4,4,7,1.06,1.35,5,7,2,2,1
Indonesia - Liga 1,Persebaya S.,2,2,5,17,8,1.21,1.12,10,14,6,4,0,2,1,4,8,2,1.59,1.0,4,10,2,1,0,0,1,1,9,6,0.82,1.24,6,4,4,3,0
Indonesia - Liga 1,Persib,3,4,13,10,4,1.76,0.97,11,15,7,0,1,2,3,5,5,2,1.88,0.71,7,8,2,0,0,1,1,8,5,2,1.65,1.24,4,7,5,0,1
Indonesia - Liga 1,Persija,1,5,8,12,8,1.38,1.12,12,10,8,4,0,1,3,6,4,3,1.71,0.88,7,6,3,1,0,0,2,2,8,5,1.06,1.35,5,4,5,3,0
Indonesia - Liga 1,Persik Kediri,1,5,3,15,10,1.18,1.24,11,10,9,2,2,0,2,1,7,7,0.88,1.12,6,5,4,2,0,1,3,2,8,3,1.47,1.35,5,5,5,0,2
Indonesia - Liga 1,Persis Solo,2,2,5,10,15,1.0,1.35,8,12,8,6,0,1,2,2,5,7,1.12,1.24,3,9,3,2,0,1,0,3,5,8,0.88,1.47,5,3,5,4,0
Indonesia - Liga 1,Persita,0,2,7,12,13,0.94,1.26,8,14,8,3,1,0,1,5,6,5,1.12,1.24,4,7,5,0,1,0,1,2,6,8,0.76,1.29,4,7,3,3,0
Indonesia - Liga 1,Semen Padang,1,2,5,18,8,1.12,1.76,7,12,8,3,4,0,1,2,11,3,1.06,1.88,4,6,3,1,3,1,1,3,7,5,1.18,1.65,3,6,5,2,1
Israel - Ligat HaAl,Ashdod,3,2,9,12,7,1.45,1.67,5,12,9,5,2,2,1,2,6,5,1.31,1.56,3,6,4,2,1,1,1,7,6,2,1.59,1.76,2,6,5,3,1
Israel - Ligat HaAl,B. Jerusalem,2,9,4,14,7,1.61,1.5,9,13,5,6,3,1,4,1,9,3,1.56,1.17,5,8,3,1,1,1,5,3,5,4,1.67,1.83,4,5,2,5,2
Israel - Ligat HaAl,H. Beer Sheva,6,6,10,10,4,2.08,0.78,15,16,3,2,0,5,5,3,4,1,2.61,0.89,7,8,1,2,0,1,1,7,6,3,1.56,0.67,8,8,2,0,0
Israel - Ligat HaAl,H. Jerusalem,4,3,5,12,9,1.42,1.27,11,9,7,5,1,3,2,3,4,5,1.65,0.94,8,5,1,3,0,1,1,2,8,4,1.19,1.63,3,4,6,2,1
Israel - Ligat HaAl,Hapoel Hadera,0,0,8,15,10,0.94,1.73,6,11,7,4,5,0,0,4,5,7,0.81,1.81,3,4,4,3,2,0,0,4,10,3,1.06,1.65,3,7,3,1,3
Israel - Ligat HaAl,Hapoel Haifa,4,3,5,14,10,1.42,1.39,11,11,6,6,2,3,2,2,9,2,1.78,1.56,4,6,3,4,1,1,1,3,5,8,1.06,1.22,7,5,3,2,1
Israel - Ligat HaAl,Ironi Tiberias,0,1,6,13,13,0.85,1.36,8,13,7,2,3,0,1,4,8,4,1.12,1.12,5,6,5,1,0,0,0,2,5,9,0.56,1.63,3,7,2,1,3
Israel - Ligat HaAl,Kiryat Shmona,0,2,8,10,13,0.97,1.58,9,10,6,3,5,0,1,6,2,8,1.0,1.35,4,7,3,2,1,0,1,2,8,5,0.94,1.81,5,3,3,1,4
Israel - Ligat HaAl,M. Bnei Raina,2,2,3,16,10,1.09,1.3,9,8,14,1,1,1,0,2,9,5,1.0,1.53,4,3,8,1,1,1,2,1,7,5,1.19,1.06,5,5,6,0,0
Israel - Ligat HaAl,M. Petah Tikva,1,0,9,9,14,0.94,1.52,9,11,7,2,4,1,0,4,5,6,1.06,1.38,4,6,4,1,1,0,0,5,4,8,0.82,1.65,5,5,3,1,3
Israel - Ligat HaAl,M. Tel Aviv,6,10,10,8,2,2.39,1.0,10,18,6,2,0,4,3,4,5,2,2.22,0.83,5,11,2,0,0,2,7,6,3,0,2.56,1.17,5,7,4,2,0
Israel - Ligat HaAl,Maccabi Haifa,5,8,8,8,7,1.89,1.5,11,9,6,8,2,3,3,2,6,4,1.72,1.78,5,3,3,6,1,2,5,6,2,3,2.06,1.22,6,6,3,2,1
Israel - Ligat HaAl,Maccabi Netanya,1,6,9,11,9,1.42,1.61,8,10,12,2,4,1,1,8,5,3,1.56,1.61,4,5,6,2,1,0,5,1,6,6,1.28,1.61,4,5,6,0,3
Israel - Ligat HaAl,Sakhnin,1,0,6,9,17,0.79,1.33,11,10,5,4,3,0,0,5,1,10,0.69,1.13,6,5,3,1,1,1,0,1,8,7,0.88,1.53,5,5,2,3,2
Israel - Leumit League,Bnei Yehuda,1,4,9,15,8,1.32,1.38,10,13,7,4,3,0,3,2,9,4,1.22,1.33,5,7,3,1,2,1,1,7,6,4,1.42,1.42,5,6,4,3,1
Israel - Leumit League,H. Ironi Rishon,3,2,7,15,10,1.35,1.49,7,13,11,4,2,1,1,4,8,4,1.39,1.28,4,8,4,1,1,2,1,3,7,6,1.32,1.68,3,5,7,3,1
Israel - Leumit League,H. Kfar Saba,0,0,15,13,9,1.16,1.32,9,12,12,3,1,0,0,11,4,3,1.44,1.22,6,4,6,2,0,0,0,4,9,6,0.89,1.42,3,8,6,1,1
Israel - Leumit League,H. Kfar Shalem,6,3,11,8,9,1.76,1.43,7,17,6,5,2,3,1,7,4,4,1.74,1.32,4,9,3,2,1,3,2,4,4,5,1.78,1.56,3,8,3,3,1
Israel - Leumit League,H. Nof Hagalil,0,5,5,11,16,0.97,1.51,8,11,12,3,3,0,2,3,6,8,0.95,1.58,3,8,4,2,2,0,3,2,5,8,1.0,1.44,5,3,8,1,1
Israel - Leumit League,H. Petah Tikva,3,6,8,16,4,1.73,0.54,23,9,4,1,0,3,3,2,9,2,1.89,0.53,12,5,1,1,0,0,3,6,7,2,1.56,0.56,11,4,3,0,0
Israel - Leumit League,H. Ramat Gan,5,6,10,7,9,1.92,0.95,16,13,5,2,1,3,5,5,3,3,2.42,1.16,8,5,4,1,1,2,1,5,4,6,1.39,0.72,8,8,1,1,0
Israel - Leumit League,H. Umm al-Fahm,0,1,7,12,17,0.78,1.73,6,9,12,9,1,0,0,3,5,10,0.61,1.17,6,6,3,3,0,0,1,4,7,7,0.95,2.26,0,3,9,6,1
Israel - Leumit League,Hapoel Afula,0,1,8,11,17,0.81,1.65,8,8,14,4,3,0,1,6,4,7,1.06,1.61,4,5,5,2,2,0,0,2,7,10,0.58,1.68,4,3,9,2,1
Israel - Leumit League,Hapoel Akko,0,2,12,12,11,1.14,1.32,11,12,7,5,2,0,1,6,5,7,1.05,0.95,7,7,4,1,0,0,1,6,7,4,1.22,1.72,4,5,3,4,2
Israel - Leumit League,Hapoel Raanana,1,2,9,12,13,1.08,1.22,10,14,9,3,1,0,0,6,8,4,1.11,1.39,2,9,5,2,0,1,2,3,4,9,1.05,1.05,8,5,4,1,1
Israel - Leumit League,Hapoel Tel Aviv,5,11,7,11,3,2.11,0.68,19,12,5,1,0,3,7,3,4,2,2.26,0.42,13,4,2,0,0,2,4,4,7,1,1.94,0.94,6,8,3,1,0
Israel - Leumit League,Kafr Qasim,1,1,6,16,13,0.95,0.89,11,21,3,2,0,1,1,4,8,5,1.21,0.89,6,10,2,1,0,0,0,2,8,8,0.67,0.89,5,11,1,1,0
Israel - Leumit League,M. Herziliya,0,3,12,13,9,1.24,1.73,8,9,11,6,3,0,1,7,6,4,1.28,1.56,4,5,6,2,1,0,2,5,7,5,1.21,1.89,4,4,5,4,2
Israel - Leumit League,Maccabi Jaffa,0,5,7,15,10,1.19,1.43,9,13,8,4,3,0,4,5,4,5,1.44,1.44,5,5,4,3,1,0,1,2,11,5,0.95,1.42,4,8,4,1,2
Israel - Leumit League,Ramat Hasharon,5,8,5,8,11,1.68,1.92,7,9,12,4,5,3,4,3,5,4,1.84,1.58,4,6,5,2,2,2,4,2,3,7,1.5,2.28,3,3,7,2,3
Italy - Serie A,AC Milan,2,6,10,15,5,1.61,1.13,13,9,14,2,0,1,4,4,6,4,1.58,0.84,8,6,5,0,0,1,2,6,9,1,1.63,1.42,5,3,9,2,0
Italy - Serie A,AS Roma,3,3,8,18,6,1.47,0.92,16,14,5,2,1,3,3,4,7,2,1.95,0.79,8,8,2,1,0,0,0,4,11,4,1.0,1.05,8,6,3,1,1
Italy - Serie A,Atalanta,7,5,11,8,7,2.05,0.97,15,14,5,3,1,2,2,8,3,4,1.89,1.26,4,9,3,3,0,5,3,3,5,3,2.21,0.68,11,5,2,0,1
Italy - Serie A,Bologna,1,4,14,12,7,1.5,1.24,12,11,9,6,0,1,3,5,9,1,1.74,0.95,7,8,2,2,0,0,1,9,3,6,1.26,1.53,5,3,7,4,0
Italy - Serie A,Cagliari,1,5,4,13,15,1.05,1.47,7,12,14,4,1,1,4,1,6,7,1.26,1.47,4,6,6,2,1,0,1,3,7,8,0.84,1.47,3,6,8,2,0
Italy - Serie A,Como,1,5,6,18,8,1.29,1.37,7,15,13,2,1,1,2,4,10,2,1.47,1.37,4,7,7,0,1,0,3,2,8,6,1.11,1.37,3,8,6,2,0
Italy - Serie A,Empoli,1,1,5,16,15,0.87,1.55,6,17,6,7,2,0,0,2,6,11,0.53,1.37,5,7,4,2,1,1,1,3,10,4,1.21,1.74,1,10,2,5,1
Italy - Serie A,Fiorentina,2,5,11,12,8,1.58,1.08,12,13,11,2,0,1,4,5,5,4,1.68,0.95,7,7,4,1,0,1,1,6,7,4,1.47,1.21,5,6,7,1,0
Italy - Serie A,Genoa,0,1,10,14,13,0.97,1.29,11,12,10,4,1,0,0,7,7,5,1.11,1.32,5,5,7,2,0,0,1,3,7,8,0.84,1.26,6,7,3,2,1
Italy - Serie A,Hellas Verona,0,4,5,12,17,0.89,1.74,8,12,8,6,4,0,2,2,5,10,0.79,1.89,5,4,3,4,3,0,2,3,7,7,1.0,1.58,3,8,5,2,1
Italy - Serie A,Inter Milan,5,8,11,10,4,2.08,0.92,16,12,8,1,1,2,5,6,5,1,2.11,1.11,6,7,5,0,1,3,3,5,5,3,2.05,0.74,10,5,3,1,0
Italy - Serie A,Juventus,2,4,13,12,7,1.53,0.92,17,12,6,1,2,1,1,10,4,3,1.63,0.79,11,3,4,0,1,1,3,3,8,4,1.42,1.05,6,9,2,1,1
Italy - Serie A,Lazio,2,5,11,14,6,1.61,1.29,9,17,9,1,2,1,3,6,7,2,1.74,1.37,2,12,4,0,1,1,2,5,7,4,1.47,1.21,7,5,5,1,1
Italy - Serie A,Lecce,0,2,3,15,18,0.71,1.53,9,15,6,3,5,0,0,3,7,9,0.68,1.63,5,7,2,2,3,0,2,0,8,9,0.74,1.42,4,8,4,1,2
Italy - Serie A,Monza,0,1,5,15,17,0.74,1.82,3,13,14,5,3,0,0,2,9,8,0.68,1.63,1,9,6,2,1,0,1,3,6,9,0.79,2.0,2,4,8,3,2
Italy - Serie A,Napoli,1,6,12,13,6,1.55,0.71,19,13,4,2,0,0,3,9,5,2,1.68,0.68,9,8,1,1,0,1,3,3,8,4,1.42,0.74,10,5,3,1,0
Italy - Serie A,Parma,0,2,13,12,11,1.16,1.53,7,14,9,7,1,0,1,8,6,4,1.32,1.47,3,9,2,5,0,0,1,5,6,7,1.0,1.58,4,5,7,2,1
Italy - Serie A,Torino,0,1,12,12,13,1.03,1.18,10,15,9,4,0,0,0,5,7,7,0.89,0.95,6,9,3,1,0,0,1,7,5,6,1.16,1.42,4,6,6,3,0
Italy - Serie A,Udinese,0,3,9,14,12,1.08,1.47,9,11,11,5,2,0,2,5,6,6,1.16,1.42,7,2,6,3,1,0,1,4,8,6,1.0,1.53,2,9,5,2,1
Italy - Serie A,Venezia,0,1,9,11,17,0.84,1.47,6,15,11,5,1,0,1,5,4,9,0.89,1.16,4,9,5,1,0,0,0,4,7,8,0.79,1.79,2,6,6,4,1
Italy - Serie B,Bari,0,3,7,18,10,1.08,1.05,13,14,7,4,0,0,1,6,9,3,1.26,1.0,6,8,4,1,0,0,2,1,9,7,0.89,1.11,7,6,3,3,0
Italy - Serie B,Brescia,1,2,8,16,11,1.11,1.26,11,12,11,3,1,1,2,4,7,5,1.32,1.37,6,6,3,3,1,0,0,4,9,6,0.89,1.16,5,6,8,0,0
Italy - Serie B,Carrarese,0,2,9,15,12,1.03,1.29,13,8,13,1,3,0,2,6,6,5,1.26,0.95,9,4,5,0,1,0,0,3,9,7,0.79,1.63,4,4,8,1,2
Italy - Serie B,Catanzaro,2,5,8,12,11,1.34,1.18,13,10,11,3,1,2,3,4,6,4,1.63,1.11,7,5,5,2,0,0,2,4,6,7,1.05,1.26,6,5,6,1,1
Italy - Serie B,Cesena,1,1,12,15,9,1.21,1.24,11,15,7,3,2,1,1,7,6,4,1.42,1.11,6,8,4,0,1,0,0,5,9,5,1.0,1.37,5,7,3,3,1
Italy - Serie B,Cittadella,0,2,5,14,17,0.79,1.47,12,9,11,3,3,0,2,2,4,11,0.74,1.47,5,4,8,1,1,0,0,3,10,6,0.84,1.47,7,5,3,2,2
Italy - Serie B,Cosenza,0,1,5,19,13,0.84,1.47,7,15,8,7,1,0,0,2,9,8,0.68,1.05,5,10,2,2,0,0,1,3,10,5,1.0,1.89,2,5,6,5,1
Italy - Serie B,Cremonese,4,5,9,13,7,1.63,1.16,8,18,10,2,0,2,2,3,10,2,1.58,1.21,3,10,5,1,0,2,3,6,3,5,1.68,1.11,5,8,5,1,0
Italy - Serie B,Frosinone,0,2,7,17,12,0.97,1.32,8,16,9,4,1,0,1,6,6,6,1.11,1.42,3,8,5,3,0,0,1,1,11,6,0.84,1.21,5,8,4,1,1
Italy - Serie B,Juve Stabia,0,3,10,13,12,1.11,1.08,12,15,7,4,0,0,2,6,7,4,1.32,0.95,8,6,3,2,0,0,1,4,6,8,0.89,1.21,4,9,4,2,0
Italy - Serie B,Mantova,0,3,14,10,11,1.24,1.47,8,12,12,4,2,0,3,5,5,6,1.26,1.0,8,5,4,2,0,0,0,9,5,5,1.21,1.95,0,7,8,2,2
Italy - Serie B,Modena,0,3,13,13,9,1.26,1.32,7,16,11,4,0,0,2,7,7,3,1.42,1.26,4,9,3,3,0,0,1,6,6,6,1.11,1.37,3,7,8,1,0
Italy - Serie B,Palermo,1,4,9,17,7,1.37,1.13,11,13,12,2,0,1,0,6,9,3,1.37,1.0,8,5,4,2,0,0,4,3,8,4,1.37,1.26,3,8,8,0,0
Italy - Serie B,Pisa,0,11,13,5,9,1.68,0.95,12,18,6,2,0,0,6,8,3,2,1.95,0.95,6,9,3,1,0,0,5,5,2,7,1.42,0.95,6,9,3,1,0
Italy - Serie B,Reggiana,0,1,14,11,12,1.11,1.37,8,13,14,2,1,0,0,10,2,7,1.16,1.26,4,7,7,1,0,0,1,4,9,5,1.05,1.47,4,6,7,1,1
Italy - Serie B,Salernitana,1,2,8,11,16,0.97,1.24,10,14,10,3,1,1,2,5,7,4,1.42,1.16,5,7,6,1,0,0,0,3,4,12,0.53,1.32,5,7,4,2,1
Italy - Serie B,Sampdoria,1,2,5,17,13,1.0,1.29,12,11,9,5,1,0,1,0,10,8,0.68,0.79,10,5,2,2,0,1,1,5,7,5,1.32,1.79,2,6,7,3,1
Italy - Serie B,Sassuolo,6,3,14,11,4,2.05,1.0,15,15,4,2,2,5,0,7,4,3,2.26,0.89,8,8,1,1,1,1,3,7,7,1,1.84,1.11,7,7,3,1,1
Italy - Serie B,Spezia,3,4,12,10,9,1.55,0.87,16,12,9,1,0,2,3,7,4,3,1.89,0.89,7,8,3,1,0,1,1,5,6,6,1.21,0.84,9,4,6,0,0
Italy - Serie B,Sudtirol,1,5,9,12,11,1.32,1.5,8,13,10,5,2,0,1,7,8,3,1.32,1.42,3,8,6,1,1,1,4,2,4,8,1.32,1.58,5,5,4,4,1
Italy - Serie C - Group A,AlbinoLeffe,0,4,11,12,11,1.21,1.0,15,14,5,3,1,0,3,4,6,6,1.21,0.79,10,5,2,2,0,0,1,7,6,5,1.21,1.21,5,9,3,1,1
Italy - Serie C - Group A,Alcione,0,1,10,10,17,0.87,0.97,11,20,5,1,1,0,0,5,5,9,0.79,1.05,6,7,5,1,0,0,1,5,5,8,0.95,0.89,5,13,0,0,1
Italy - Serie C - Group A,Arzignano,0,5,6,18,9,1.18,1.21,11,15,7,3,2,0,3,2,11,3,1.26,1.16,6,6,6,0,1,0,2,4,7,6,1.11,1.26,5,9,1,3,1
Italy - Serie C - Group A,Atalanta B,5,3,9,15,6,1.71,1.39,8,15,7,8,0,4,1,5,6,3,1.95,1.26,4,9,3,3,0,1,2,4,9,3,1.47,1.53,4,6,4,5,0
Italy - Serie C - Group A,Caldiero Terme,1,1,9,14,13,1.03,1.68,8,7,16,5,2,1,0,6,5,7,1.11,1.47,4,4,9,2,0,0,1,3,9,6,0.95,1.89,4,3,7,3,2
Italy - Serie C - Group A,Clodiense,0,0,7,20,11,0.89,1.76,4,12,14,6,2,0,0,4,11,4,1.0,1.53,2,8,6,3,0,0,0,3,9,7,0.79,2.0,2,4,8,3,2
Italy - Serie C - Group A,FeralpiSalo,0,7,10,12,9,1.39,0.79,18,14,3,2,1,0,3,7,8,1,1.63,0.47,11,7,1,0,0,0,4,3,4,8,1.16,1.11,7,7,2,2,1
Italy - Serie C - Group A,Giana Erminio,0,5,9,11,13,1.16,1.03,11,17,8,2,0,0,3,5,5,6,1.26,0.95,5,10,4,0,0,0,2,4,6,7,1.05,1.11,6,7,4,2,0
Italy - Serie C - Group A,Lecco,1,1,6,16,14,0.95,1.24,9,18,7,2,2,1,1,4,9,4,1.32,1.0,5,10,3,1,0,0,0,2,7,10,0.58,1.47,4,8,4,1,2
Italy - Serie C - Group A,Lumezzane,1,3,6,15,13,1.05,1.45,7,13,13,4,1,1,1,3,6,8,1.0,1.53,4,4,8,3,0,0,2,3,9,5,1.11,1.37,3,9,5,1,1
Italy - Serie C - Group A,Novara,0,5,8,11,14,1.11,1.03,14,15,6,2,1,0,4,4,4,7,1.26,0.68,10,7,0,2,0,0,1,4,7,7,0.95,1.37,4,8,6,0,1
Italy - Serie C - Group A,Padova,2,7,11,14,4,1.71,0.63,17,19,1,1,0,1,5,5,7,1,1.89,0.53,9,10,0,0,0,1,2,6,7,3,1.53,0.74,8,9,1,1,0
Italy - Serie C - Group A,Pergolettese,0,2,6,18,12,0.95,1.29,10,12,13,2,1,0,2,3,8,6,1.05,1.21,5,5,9,0,0,0,0,3,10,6,0.84,1.37,5,7,4,2,1
Italy - Serie C - Group A,Pro Patria,1,1,3,19,14,0.84,1.16,8,18,10,2,0,1,1,1,10,6,1.0,1.0,5,10,3,1,0,0,0,2,9,8,0.68,1.32,3,8,7,1,0
Italy - Serie C - Group A,Pro Vercelli,0,2,5,14,17,0.79,1.34,9,14,9,5,1,0,2,2,7,8,0.89,1.16,7,5,4,3,0,0,0,3,7,9,0.68,1.53,2,9,5,2,1
Italy - Serie C - Group A,Renate,0,1,9,14,14,0.92,0.95,15,14,6,2,1,0,1,2,8,8,0.79,0.84,8,7,3,1,0,0,0,7,6,6,1.05,1.05,7,7,3,1,1
Italy - Serie C - Group A,Trento,2,3,8,12,13,1.24,1.11,12,14,8,4,0,2,3,3,8,3,1.74,0.95,7,7,4,1,0,0,0,5,4,10,0.74,1.26,5,7,4,3,0
Italy - Serie C - Group A,Triestina,1,4,4,14,15,1.05,1.18,12,14,7,4,1,1,2,2,8,6,1.26,1.0,8,7,2,1,1,0,2,2,6,9,0.84,1.37,4,7,5,3,0
Italy - Serie C - Group A,Vicenza,2,4,12,15,5,1.55,0.63,21,11,5,1,0,2,3,7,7,0,2.0,0.37,13,5,1,0,0,0,1,5,8,5,1.11,0.89,8,6,4,1,0
Italy - Serie C - Group A,Virtus Verona,2,4,7,17,8,1.37,1.13,12,15,6,4,1,2,0,3,11,3,1.37,1.21,4,8,6,1,0,0,4,4,6,5,1.37,1.05,8,7,0,3,1
Italy - Serie C - Group B,AC Milan B,0,1,9,15,13,0.95,1.5,7,14,11,4,2,0,1,4,8,6,1.0,1.58,4,5,7,2,1,0,0,5,7,7,0.89,1.42,3,9,4,2,1
Italy - Serie C - Group B,Arezzo,2,2,8,18,8,1.26,0.97,18,8,8,3,1,2,0,4,9,4,1.32,0.89,8,7,3,0,1,0,2,4,9,4,1.21,1.05,10,1,5,3,0
Italy - Serie C - Group B,Ascoli,1,0,7,19,11,0.97,1.21,8,16,12,2,0,1,0,2,10,6,0.95,1.16,4,9,5,1,0,0,0,5,9,5,1.0,1.26,4,7,7,1,0
Italy - Serie C - Group B,Athletic Carpi,1,2,9,13,13,1.08,1.26,10,13,12,1,2,0,0,6,5,8,0.89,1.16,6,5,7,1,0,1,2,3,8,5,1.26,1.37,4,8,5,0,2
Italy - Serie C - Group B,Campobasso,1,2,8,10,17,0.95,1.21,11,12,11,4,0,1,2,5,5,6,1.32,1.11,6,6,6,1,0,0,0,3,5,11,0.58,1.32,5,6,5,3,0
Italy - Serie C - Group B,Entella,2,4,13,15,4,1.61,0.63,16,20,2,0,0,2,3,6,5,3,1.79,0.63,7,12,0,0,0,0,1,7,10,1,1.42,0.63,9,8,2,0,0
Italy - Serie C - Group B,Gubbio,0,2,3,20,13,0.84,1.11,14,10,10,4,0,0,2,1,9,7,0.89,0.95,9,4,4,2,0,0,0,2,11,6,0.79,1.26,5,6,6,2,0
Italy - Serie C - Group B,Legnago Salus,0,2,6,12,18,0.79,1.66,6,17,4,10,1,0,0,5,5,9,0.79,1.89,1,8,2,8,0,0,2,1,7,9,0.79,1.42,5,9,2,2,1
Italy - Serie C - Group B,Lucchese,1,4,10,11,12,1.24,1.68,9,11,7,6,5,1,3,8,4,3,1.74,1.47,3,8,4,4,0,0,1,2,7,9,0.74,1.89,6,3,3,2,5
Italy - Serie C - Group B,Perugia,1,4,7,13,13,1.13,1.08,14,11,10,2,1,1,3,5,5,5,1.47,0.79,9,7,2,0,1,0,1,2,8,8,0.79,1.37,5,4,8,2,0
Italy - Serie C - Group B,Pescara,2,5,12,8,11,1.45,0.92,12,19,5,2,0,2,1,6,4,6,1.42,0.84,6,10,3,0,0,0,4,6,4,5,1.47,1.0,6,9,2,2,0
Italy - Serie C - Group B,Pianese,1,5,9,11,12,1.26,1.26,11,14,6,6,1,1,3,5,6,4,1.53,1.16,6,8,1,4,0,0,2,4,5,8,1.0,1.37,5,6,5,2,1
Italy - Serie C - Group B,Pineto,0,5,5,21,7,1.21,1.29,12,13,6,4,3,0,3,2,11,3,1.26,0.89,8,7,3,0,1,0,2,3,10,4,1.16,1.68,4,6,3,4,2
Italy - Serie C - Group B,Pontedera,4,4,4,17,9,1.42,1.42,7,15,11,4,1,3,2,3,6,5,1.63,1.37,2,10,5,2,0,1,2,1,11,4,1.21,1.47,5,5,6,2,1
Italy - Serie C - Group B,Rimini,3,3,5,13,14,1.18,0.92,12,18,7,1,0,2,0,1,7,9,0.95,0.84,6,10,3,0,0,1,3,4,6,5,1.42,1.0,6,8,4,1,0
Italy - Serie C - Group B,SPAL,0,4,5,19,10,1.08,1.61,6,15,9,5,3,0,1,4,8,6,1.0,1.47,2,9,5,3,0,0,3,1,11,4,1.16,1.74,4,6,4,2,3
Italy - Serie C - Group B,Sestri Levante,0,2,8,12,16,0.89,1.42,10,14,6,4,4,0,1,4,7,7,0.95,1.37,4,8,3,4,0,0,1,4,5,9,0.84,1.47,6,6,3,0,4
Italy - Serie C - Group B,Ternana,3,8,7,9,11,1.68,0.61,19,17,1,0,1,3,5,3,4,4,2.21,0.58,9,9,1,0,0,0,3,4,5,7,1.16,0.63,10,8,0,0,1
Italy - Serie C - Group B,Torres,2,5,10,11,10,1.45,0.95,13,16,7,2,0,1,2,4,5,7,1.21,0.63,10,6,3,0,0,1,3,6,6,3,1.68,1.26,3,10,4,2,0
Italy - Serie C - Group B,Vis Pesaro,1,3,6,19,9,1.16,0.89,16,13,6,3,0,1,2,4,8,4,1.37,0.74,9,7,2,1,0,0,1,2,11,5,0.95,1.05,7,6,4,2,0
Jamaica - Premier League,Arnett Gardens,6,4,11,12,6,1.9,0.92,16,12,9,2,0,3,3,5,5,4,1.9,0.95,6,9,5,0,0,3,1,6,7,2,1.89,0.89,10,3,4,2,0
Jamaica - Premier League,Cavalier,3,4,14,12,6,1.67,1.1,9,21,5,4,0,3,2,7,5,2,2.0,1.16,4,10,3,2,0,0,2,7,7,4,1.35,1.05,5,11,2,2,0
Jamaica - Premier League,Chapelton,0,3,5,17,14,0.92,1.46,6,18,9,4,2,0,0,4,9,6,0.89,1.47,3,9,4,2,1,0,3,1,8,8,0.95,1.45,3,9,5,2,1
Jamaica - Premier League,Dunbeholden,0,4,6,10,19,0.87,1.72,9,10,9,5,6,0,3,5,4,7,1.21,1.42,5,5,6,2,1,0,1,1,6,12,0.55,2.0,4,5,3,3,5
Jamaica - Premier League,Harbour View,2,2,5,12,18,0.97,1.49,8,17,7,4,3,2,2,4,3,8,1.42,0.95,6,8,5,0,0,0,0,1,9,10,0.55,2.0,2,9,2,4,3
Jamaica - Premier League,Humble Lions,0,3,2,21,13,0.87,1.67,7,15,9,3,5,0,3,1,9,8,0.95,1.14,6,10,3,0,2,0,0,1,12,5,0.78,2.28,1,5,6,3,3
Jamaica - Premier League,Molynes Utd,2,4,6,7,20,1.03,1.95,9,11,4,7,8,1,3,2,4,9,1.11,1.89,2,8,3,4,2,1,1,4,3,11,0.95,2.0,7,3,1,3,6
Jamaica - Premier League,Montego Bay,6,4,6,13,10,1.59,0.72,19,13,6,1,0,3,3,4,6,3,1.89,0.58,10,7,2,0,0,3,1,2,7,7,1.3,0.85,9,6,4,1,0
Jamaica - Premier League,Mount Pleasant,9,9,8,10,3,2.41,0.54,25,8,5,1,0,5,5,3,4,2,2.42,0.16,16,3,0,0,0,4,4,5,6,1,2.4,0.9,9,5,5,1,0
Jamaica - Premier League,Portmore Utd,2,1,9,12,15,1.05,0.64,19,16,3,1,0,2,0,6,6,7,1.24,0.62,10,9,2,0,0,0,1,3,6,8,0.83,0.67,9,7,1,1,0
Jamaica - Premier League,Racing United,0,4,7,17,11,1.1,1.28,12,13,7,5,2,0,2,4,9,4,1.21,1.16,8,5,2,3,1,0,2,3,8,7,1.0,1.4,4,8,5,2,1
Jamaica - Premier League,Tivoli Gardens,3,4,11,12,9,1.56,1.23,12,13,10,2,2,2,3,5,6,3,1.89,1.11,6,10,1,0,2,1,1,6,6,6,1.25,1.35,6,3,9,2,0
Jamaica - Premier League,Vere Utd,0,2,4,18,15,0.82,2.1,5,8,14,7,5,0,1,3,7,8,0.84,2.21,3,3,6,4,3,0,1,1,11,7,0.8,2.0,2,5,8,3,2
Jamaica - Premier League,Waterhouse,0,4,8,16,11,1.13,1.08,14,14,5,6,0,0,2,4,8,7,1.05,1.1,7,8,3,3,0,0,2,4,8,4,1.22,1.06,7,6,2,3,0
Japan - J1 League,Albirex Niigata,0,1,5,11,7,1.0,1.71,4,6,8,5,1,0,1,4,3,4,1.17,1.75,2,3,4,2,1,0,0,1,8,3,0.83,1.67,2,3,4,3,0
Japan - J1 League,Avispa Fukuoka,0,1,3,12,7,0.91,1.0,9,6,7,1,0,0,1,3,5,4,1.08,1.0,4,5,4,0,0,0,0,0,7,3,0.7,1.0,5,1,3,1,0
Japan - J1 League,Cerezo Osaka,2,3,5,9,5,1.54,1.38,4,8,11,1,0,1,0,3,7,1,1.42,1.0,3,6,3,0,0,1,3,2,2,4,1.67,1.75,1,2,8,1,0
Japan - J1 League,FC Tokyo,0,5,4,4,11,1.13,1.42,5,8,7,4,0,0,3,2,2,5,1.25,1.33,3,4,3,2,0,0,2,2,2,6,1.0,1.5,2,4,4,2,0
Japan - J1 League,Fagiano Okayama,0,0,5,10,9,0.83,0.92,8,10,6,0,0,0,0,4,5,4,1.0,0.85,5,5,3,0,0,0,0,1,5,5,0.64,1.0,3,5,3,0,0
Japan - J1 League,Gamba Osaka,1,1,8,6,8,1.21,1.29,8,8,3,4,1,1,0,6,1,3,1.55,1.0,4,6,0,0,1,0,1,2,5,5,0.92,1.54,4,2,3,4,0
Japan - J1 League,K. Frontale,1,3,9,7,4,1.58,1.08,7,9,7,1,0,1,2,6,1,2,1.92,1.08,4,4,3,1,0,0,1,3,6,2,1.25,1.08,3,5,4,0,0
Japan - J1 League,Kashima Antlers,1,4,4,12,3,1.5,1.0,9,9,4,1,1,1,2,3,7,0,1.77,0.92,6,4,2,0,1,0,2,1,5,3,1.18,1.09,3,5,2,1,0
Japan - J1 League,Kashiwa Reysol,0,2,7,13,2,1.38,0.96,11,8,0,5,0,0,1,2,7,1,1.27,1.09,5,3,0,3,0,0,1,5,6,1,1.46,0.85,6,5,0,2,0
Japan - J1 League,Kyoto Sanga,1,4,8,8,3,1.67,1.21,5,12,4,3,0,0,2,4,4,1,1.64,0.91,3,7,0,1,0,1,2,4,4,2,1.69,1.46,2,5,4,2,0
Japan - J1 League,Machida Zelvia,1,2,9,6,6,1.42,1.04,8,8,7,1,0,0,2,2,3,4,1.18,1.27,3,3,4,1,0,1,0,7,3,2,1.62,0.85,5,5,3,0,0
Japan - J1 League,Nagoya G.,0,2,6,10,6,1.17,1.38,5,9,7,2,1,0,1,5,3,2,1.45,0.91,4,4,3,0,0,0,1,1,7,4,0.92,1.77,1,5,4,2,1
Japan - J1 League,S. Hiroshima,1,1,5,12,5,1.21,0.75,9,12,3,0,0,0,0,3,6,2,1.09,0.91,3,6,2,0,0,1,1,2,6,3,1.31,0.62,6,6,1,0,0
Japan - J1 League,Shimizu S-Pulse,0,4,5,7,8,1.21,1.33,6,8,7,2,1,0,3,3,3,3,1.5,1.17,4,3,4,1,0,0,1,2,4,5,0.92,1.5,2,5,3,1,1
Japan - J1 League,Shonan Bellmare,0,1,4,8,10,0.83,1.43,5,9,5,2,2,0,1,2,5,4,1.0,1.17,2,7,2,1,0,0,0,2,3,6,0.64,1.73,3,2,3,1,2
Japan - J1 League,Tokyo Verdy,0,0,4,7,13,0.63,1.0,11,5,6,1,1,0,0,3,3,6,0.75,1.0,4,5,2,1,0,0,0,1,4,7,0.5,1.0,7,0,4,0,1
Japan - J1 League,Urawa RD,0,2,7,8,5,1.27,1.05,6,10,5,1,0,0,2,4,2,3,1.45,0.82,4,5,2,0,0,0,0,3,6,2,1.09,1.27,2,5,3,1,0
Japan - J1 League,Vissel Kobe,1,2,9,6,6,1.42,0.92,8,12,2,2,0,1,1,3,4,3,1.42,0.83,5,5,1,1,0,0,1,6,2,3,1.42,1.0,3,7,1,1,0
Japan - J1 League,Yokohama FC,0,0,2,10,12,0.58,1.25,7,7,8,1,1,0,0,2,4,7,0.62,1.15,4,6,1,1,1,0,0,0,6,5,0.55,1.36,3,1,7,0,0
Japan - J1 League,Yokohama M.,0,4,2,7,11,0.96,1.33,6,9,4,5,0,0,2,2,3,6,1.0,1.31,4,4,2,3,0,0,2,0,4,5,0.91,1.36,2,5,2,2,0
Japan - J2 League,Blaublitz Akita,0,1,7,11,4,1.22,1.83,2,8,8,3,2,0,1,3,4,3,1.18,1.82,1,2,6,2,0,0,0,4,7,1,1.25,1.83,1,6,2,1,2
Japan - J2 League,C. Sapporo,0,3,6,9,5,1.3,1.7,3,9,6,3,2,0,1,5,3,1,1.6,1.6,2,3,3,1,1,0,2,1,6,4,1.08,1.77,1,6,3,2,1
Japan - J2 League,Ehime FC,0,1,5,10,7,1.0,1.74,3,9,6,2,3,0,0,3,4,4,0.91,1.73,2,3,3,2,1,0,1,2,6,3,1.08,1.75,1,6,3,0,2
Japan - J2 League,FC Imabari,2,2,4,5,10,1.17,1.0,9,8,4,1,1,1,1,2,3,6,1.08,1.23,4,5,2,1,1,1,1,2,2,4,1.3,0.7,5,3,2,0,0
Japan - J2 League,Fujieda MYFC,1,2,5,6,9,1.13,1.3,6,7,7,3,0,0,1,4,2,5,1.08,1.5,2,4,4,2,0,1,1,1,4,4,1.18,1.09,4,3,3,1,0
Japan - J2 League,Iwaki,2,1,4,8,8,1.22,1.39,1,15,5,1,1,1,1,1,6,3,1.33,1.17,0,10,2,0,0,1,0,3,2,5,1.09,1.64,1,5,3,1,1
Japan - J2 League,JEF Utd Chiba,1,5,4,5,8,1.43,0.91,8,10,4,1,0,1,2,2,2,4,1.55,0.91,4,4,3,0,0,0,3,2,3,4,1.33,0.92,4,6,1,1,0
Japan - J2 League,Jubilo Iwata,3,3,3,8,6,1.57,1.22,7,7,6,3,0,2,1,2,4,3,1.67,0.83,5,5,1,1,0,1,2,1,4,3,1.45,1.64,2,2,5,2,0
Japan - J2 League,Kataller Toyama,0,1,4,8,10,0.83,1.17,7,7,7,2,0,0,1,2,4,4,1.0,1.0,3,5,3,0,0,0,0,2,4,6,0.67,1.33,4,2,4,2,0
Japan - J2 League,M. Yamagata,1,5,3,6,8,1.35,1.52,5,7,7,2,2,1,2,1,1,5,1.3,1.7,3,2,2,1,2,0,3,2,5,3,1.38,1.38,2,5,5,1,0
Japan - J2 League,Mito Hollyhock,1,3,8,7,4,1.57,0.74,11,8,3,1,0,1,3,3,4,2,1.77,0.62,6,6,1,0,0,0,0,5,3,2,1.3,0.9,5,2,2,1,0
Japan - J2 League,Oita Trinita,0,1,3,11,8,0.87,1.0,8,8,6,1,0,0,0,2,6,3,0.91,0.64,6,3,2,0,0,0,1,1,5,5,0.83,1.33,2,5,4,1,0
Japan - J2 League,Omiya Ardija,1,2,8,6,6,1.39,0.91,9,8,5,1,0,0,1,6,4,1,1.58,0.92,5,3,4,0,0,1,1,2,2,5,1.18,0.91,4,5,1,1,0
Japan - J2 League,R. Kumamoto,0,2,6,8,7,1.13,1.57,7,6,3,5,2,0,2,2,3,5,1.08,1.42,4,3,2,2,1,0,0,4,5,2,1.18,1.73,3,3,1,3,1
Japan - J2 League,R. Yamaguchi,0,0,5,9,9,0.83,1.22,6,7,9,1,0,0,0,3,6,3,1.0,1.0,4,4,4,0,0,0,0,2,3,6,0.64,1.45,2,3,5,1,0
Japan - J2 League,Sagan Tosu,0,0,8,9,6,1.09,0.91,9,10,2,1,1,0,0,5,6,2,1.23,1.0,5,5,2,0,1,0,0,3,3,4,0.9,0.8,4,5,0,1,0
Japan - J2 League,Tokushima V.,0,1,6,8,8,1.0,0.57,13,8,1,1,0,0,1,2,4,4,1.0,0.73,6,3,1,1,0,0,0,4,4,4,1.0,0.42,7,5,0,0,0
Japan - J2 League,V-V. Nagasaki,1,4,6,10,2,1.7,1.52,4,10,4,3,2,1,3,0,6,1,1.82,1.27,4,3,2,1,1,0,1,6,4,1,1.58,1.75,0,7,2,2,1
Japan - J2 League,Vegalta Sendai,1,1,6,9,6,1.22,0.91,9,10,1,3,0,0,1,3,4,3,1.18,0.82,4,6,0,1,0,1,0,3,5,3,1.25,1.0,5,4,1,2,0
Japan - J2 League,Ventforet Kofu,2,1,0,12,8,1.0,0.87,12,3,7,1,0,0,1,0,8,2,1.0,1.0,5,2,3,1,0,2,0,0,4,6,1.0,0.75,7,1,4,0,0
Japan - J3 League,AC Numazu,1,3,1,6,10,1.0,1.14,7,9,1,3,1,1,2,0,2,6,1.09,0.64,5,5,1,0,0,0,1,1,4,4,0.9,1.7,2,4,0,3,1
Japan - J3 League,FC Ryukyu,0,1,5,7,8,0.95,1.19,5,10,3,3,0,0,0,2,4,4,0.8,1.0,3,5,1,1,0,0,1,3,3,4,1.09,1.36,2,5,2,2,0
Japan - J3 League,Fukushima Utd,1,4,6,7,3,1.67,2.19,4,4,5,4,4,1,4,2,2,1,2.2,2.1,2,2,1,3,2,0,0,4,5,2,1.18,2.27,2,2,4,1,2
Japan - J3 League,G. Kitakyushu,0,1,4,11,5,1.05,1.05,9,6,3,2,1,0,0,2,8,1,1.09,0.82,6,2,2,1,0,0,1,2,3,4,1.0,1.3,3,4,1,1,1
Japan - J3 League,Gainare Tottori,1,1,4,5,10,0.95,1.05,7,9,2,3,0,1,1,3,4,1,1.7,0.6,6,3,0,1,0,0,0,1,1,9,0.27,1.45,1,6,2,2,0
Japan - J3 League,Gifu,0,2,4,10,5,1.14,1.67,1,13,2,3,2,0,1,2,6,2,1.18,1.27,1,7,2,1,0,0,1,2,4,3,1.1,2.1,0,6,0,2,2
Japan - J3 League,Kagoshima Utd,2,2,4,10,3,1.62,1.1,6,8,6,1,0,2,1,1,7,0,2.0,1.09,3,4,4,0,0,0,1,3,3,3,1.2,1.1,3,4,2,1,0
Japan - J3 League,Kamatamare S.,1,1,3,7,9,0.95,1.24,3,12,4,2,0,1,0,2,4,4,1.09,1.27,2,5,3,1,0,0,1,1,3,5,0.8,1.2,1,7,1,1,0
Japan - J3 League,Kochi United,2,2,6,5,6,1.52,1.71,4,6,6,3,2,0,2,1,4,3,1.2,1.7,2,2,5,0,1,2,0,5,1,3,1.82,1.73,2,4,1,3,1
Japan - J3 League,Kusatsu,1,3,5,5,7,1.33,1.48,7,5,4,3,2,0,1,3,1,6,0.91,0.82,6,2,2,1,0,1,2,2,4,1,1.8,2.2,1,3,2,2,2
Japan - J3 League,Matsumoto Y.,0,2,5,8,6,1.14,1.29,6,8,4,2,1,0,1,3,4,2,1.3,1.5,3,3,2,1,1,0,1,2,4,4,1.0,1.09,3,5,2,1,0
Japan - J3 League,Nagano Parceiro,0,1,2,10,8,0.81,1.1,8,5,6,2,0,0,1,1,7,1,1.2,1.1,4,2,3,1,0,0,0,1,3,7,0.45,1.09,4,3,3,1,0
Japan - J3 League,Nara Club,1,1,6,8,5,1.29,1.14,4,12,3,2,0,1,1,4,3,2,1.64,0.73,4,6,1,0,0,0,0,2,5,3,0.9,1.6,0,6,2,2,0
Japan - J3 League,Osaka,2,3,2,9,5,1.57,0.71,10,8,2,1,0,2,2,0,6,1,2.09,0.64,6,4,0,1,0,0,1,2,3,4,1.0,0.8,4,4,2,0,0
Japan - J3 League,SC Sagamihara,0,2,3,10,6,1.05,1.29,4,10,5,1,1,0,1,0,6,3,0.9,0.9,3,5,2,0,0,0,1,3,4,3,1.18,1.64,1,5,3,1,1
Japan - J3 League,T. Miyazaki,1,3,3,9,5,1.33,1.05,7,8,4,2,0,1,2,1,4,3,1.45,1.09,3,5,2,1,0,0,1,2,5,2,1.2,1.0,4,3,2,1,0
Japan - J3 League,Tochigi City,1,3,6,7,4,1.57,0.9,7,9,5,0,0,0,2,4,3,1,1.7,1.0,3,4,3,0,0,1,1,2,4,3,1.45,0.82,4,5,2,0,0
Japan - J3 League,Tochigi SC,0,1,1,11,8,0.76,1.0,8,7,5,0,1,0,1,0,7,3,0.91,0.82,4,5,2,0,0,0,0,1,4,5,0.6,1.2,4,2,3,0,1
Japan - J3 League,V. Hachinohe,1,1,4,12,3,1.33,0.62,11,7,3,0,0,1,1,4,4,1,1.82,0.64,6,3,2,0,0,0,0,0,8,2,0.8,0.6,5,4,1,0,0
Japan - J3 League,Z. Kanazawa,0,1,4,11,5,1.05,1.19,3,12,5,1,0,0,1,2,3,3,1.11,1.22,1,5,3,0,0,0,0,2,8,2,1.0,1.17,2,7,2,1,0
Kazakhstan - Premier League,Aktobe,2,2,3,6,4,1.53,0.71,8,6,3,0,0,1,0,2,3,2,1.38,0.63,4,3,1,0,0,1,2,1,3,2,1.67,0.78,4,3,2,0,0
Kazakhstan - Premier League,Atyrau,0,0,1,8,9,0.56,2.06,2,4,8,0,4,0,0,1,5,4,0.7,1.9,1,3,4,0,2,0,0,0,3,5,0.38,2.25,1,1,4,0,2
Kazakhstan - Premier League,FC Astana,3,2,7,5,1,2.28,0.89,8,6,2,2,0,3,2,2,2,0,3.11,1.44,2,3,2,2,0,0,0,5,3,1,1.44,0.33,6,3,0,0,0
Kazakhstan - Premier League,Kairat Almaty,5,0,5,5,2,2.06,0.76,6,9,2,0,0,3,0,1,3,0,2.43,0.57,4,2,1,0,0,2,0,4,2,2,1.8,0.9,2,7,1,0,0
Kazakhstan - Premier League,Kaisar K.,0,0,4,9,4,1.0,1.76,3,5,6,0,3,0,0,2,6,2,1.0,1.1,3,3,4,0,0,0,0,2,3,2,1.0,2.71,0,2,2,0,3
Kazakhstan - Premier League,Kyzylzhar,0,1,6,4,6,1.12,1.29,3,9,2,3,0,0,0,3,3,3,1.0,1.22,1,6,1,1,0,0,1,3,1,3,1.25,1.38,2,3,1,2,0
Kazakhstan - Premier League,Okzhetpes,1,2,5,5,4,1.47,1.41,4,6,5,1,1,1,1,1,3,2,1.5,1.38,1,4,2,1,0,0,1,4,2,2,1.44,1.44,3,2,3,0,1
Kazakhstan - Premier League,Ordabasy,1,0,2,6,7,0.94,0.81,8,5,2,0,1,1,0,0,4,4,1.0,0.33,6,3,0,0,0,0,0,2,2,3,0.86,1.43,2,2,2,0,1
Kazakhstan - Premier League,Tobol,1,2,7,4,2,1.81,0.81,6,7,3,0,0,1,0,6,1,0,2.25,0.75,3,4,1,0,0,0,2,1,3,2,1.38,0.88,3,3,2,0,0
Kazakhstan - Premier League,Turan,0,1,1,8,7,0.76,1.94,3,3,8,1,2,0,0,1,5,3,0.78,1.33,3,1,4,1,0,0,1,0,3,4,0.75,2.63,0,2,4,0,2
Kazakhstan - Premier League,Ulytau,0,0,1,8,8,0.59,1.41,3,7,5,1,1,0,0,1,4,2,0.86,1.71,0,4,2,0,1,0,0,0,4,6,0.4,1.2,3,3,3,1,0
Kazakhstan - Premier League,Yelimay Semey,0,2,4,8,3,1.29,1.06,5,7,4,1,0,0,1,3,2,2,1.38,1.25,3,1,3,1,0,0,1,1,6,1,1.22,0.89,2,6,1,0,0
Kazakhstan - Premier League,Zhenys,0,1,7,3,6,1.18,0.94,7,6,3,0,1,0,1,3,1,4,1.11,0.78,4,3,2,0,0,0,0,4,2,2,1.25,1.13,3,3,1,0,1
Kazakhstan - Premier League,Zhetysu,0,0,4,6,7,0.82,1.47,4,5,4,4,0,0,0,2,2,4,0.75,1.38,3,1,2,2,0,0,0,2,4,3,0.89,1.56,1,4,2,2,0
Latvia - Virsliga,Auda,2,1,6,11,3,1.48,1.13,9,6,4,4,0,1,1,4,6,0,1.75,1.08,6,2,1,3,0,1,0,2,5,3,1.18,1.18,3,4,3,1,0
Latvia - Virsliga,Daugavpils,1,3,5,11,3,1.48,1.83,4,9,5,1,4,1,2,2,5,1,1.73,1.64,3,3,4,0,1,0,1,3,6,2,1.25,2.0,1,6,1,1,3
Latvia - Virsliga,FS Jelgava,1,1,4,5,12,0.87,1.09,4,14,4,1,0,1,1,4,3,3,1.5,0.92,2,9,1,0,0,0,0,0,2,9,0.18,1.27,2,5,3,1,0
Latvia - Virsliga,Grobina,0,1,4,10,8,0.91,1.91,4,6,7,2,4,0,1,3,5,2,1.27,1.55,3,3,3,0,2,0,0,1,5,6,0.58,2.25,1,3,4,2,2
Latvia - Virsliga,Liepaja,3,2,7,6,5,1.65,1.57,7,5,6,2,3,2,0,5,3,2,1.75,1.08,6,3,1,1,1,1,2,2,3,3,1.55,2.09,1,2,5,1,2
Latvia - Virsliga,Metta,1,1,2,7,12,0.78,2.04,3,5,8,2,5,0,1,2,2,6,0.82,2.0,2,2,3,2,2,1,0,0,5,6,0.75,2.08,1,3,5,0,3
Latvia - Virsliga,RFS,7,0,8,6,2,2.48,0.87,8,11,3,1,0,3,0,4,3,1,2.36,0.45,6,5,0,0,0,4,0,4,3,1,2.58,1.25,2,6,3,1,0
Latvia - Virsliga,Riga FC,2,9,6,6,0,2.39,0.65,12,7,4,0,0,0,4,5,3,0,2.08,0.58,7,3,2,0,0,2,5,1,3,0,2.73,0.73,5,4,2,0,0
Latvia - Virsliga,Super Nova,2,0,3,12,6,1.13,1.39,4,10,7,1,1,2,0,0,8,2,1.33,1.33,3,6,1,1,1,0,0,3,4,4,0.91,1.45,1,4,6,0,0
Latvia - Virsliga,Tukums,0,1,9,4,9,1.09,1.78,5,5,6,5,2,0,0,7,2,2,1.45,1.91,3,2,2,2,2,0,1,2,2,7,0.75,1.67,2,3,4,3,0
Latvia - 1. Liga,AFA Olaine,0,3,2,5,3,1.38,2.85,1,4,1,2,5,0,2,0,3,2,1.29,2.14,1,3,0,1,2,0,1,2,2,1,1.5,3.67,0,1,1,1,3
Latvia - 1. Liga,Alberts JDFS,3,0,5,4,1,2.31,0.85,6,5,1,0,1,2,0,2,2,1,2.57,0.57,4,2,1,0,0,1,0,3,2,0,2.0,1.17,2,3,0,0,1
Latvia - 1. Liga,Augsdaugava,1,0,1,3,8,0.69,2.0,2,4,3,2,2,1,0,1,1,2,1.4,2.0,1,2,0,1,1,0,0,0,2,6,0.25,2.0,1,2,3,1,1
Latvia - 1. Liga,JFK Ventspils,0,1,6,5,1,1.54,0.85,4,7,2,0,0,0,0,3,2,1,1.33,0.83,2,3,1,0,0,0,1,3,3,0,1.71,0.86,2,4,1,0,0
Latvia - 1. Liga,Leevon PPK,3,1,1,4,4,1.77,1.46,2,5,5,0,1,2,1,0,1,2,2.33,2.0,0,2,3,0,1,1,0,1,3,2,1.29,1.0,2,3,2,0,0
Latvia - 1. Liga,Marupe,1,0,3,7,2,1.31,1.08,4,5,3,1,0,0,0,2,6,0,1.25,0.88,4,1,3,0,0,1,0,1,1,2,1.4,1.4,0,4,0,1,0
Latvia - 1. Liga,Ogre United,2,4,1,6,0,2.46,1.23,4,4,3,2,0,2,1,0,1,0,4.0,0.75,1,3,0,0,0,0,3,1,5,0,1.78,1.44,3,1,3,2,0
Latvia - 1. Liga,RFS B,2,2,4,3,2,1.92,1.31,3,5,3,2,0,2,1,2,3,1,2.0,1.22,2,4,2,1,0,0,1,2,0,1,1.75,1.5,1,1,1,1,0
Latvia - 1. Liga,Rezekne,0,1,4,5,3,1.23,2.54,1,6,1,2,3,0,0,2,2,2,1.0,1.83,1,3,0,1,1,0,1,2,3,1,1.43,3.14,0,3,1,1,2
Latvia - 1. Liga,Riga FC B,0,0,3,6,4,0.92,2.0,1,4,5,1,2,0,0,3,3,1,1.29,1.57,1,2,3,1,0,0,0,0,3,3,0.5,2.5,0,2,2,0,2
Latvia - 1. Liga,Riga Mariners,5,2,2,4,0,2.85,1.23,2,7,3,1,0,2,1,1,3,0,2.29,1.29,2,2,2,1,0,3,1,1,1,0,3.5,1.17,0,5,1,0,0
Latvia - 1. Liga,Skanste,0,0,6,5,2,1.31,1.46,3,6,1,1,2,0,0,3,4,0,1.43,1.0,2,4,0,1,0,0,0,3,1,2,1.17,2.0,1,2,1,0,2
Latvia - 1. Liga,Smiltene,3,1,1,6,2,1.92,1.77,1,4,6,1,1,3,1,0,1,1,3.0,1.67,1,2,2,0,1,0,0,1,5,1,1.0,1.86,0,2,4,1,0
Latvia - 1. Liga,Tukums B,0,1,1,8,3,1.0,2.0,1,5,3,1,3,0,1,1,4,0,1.5,1.83,0,2,3,1,0,0,0,0,4,3,0.57,2.14,1,3,0,0,3
Lithuania - A Lyga,Banga,0,0,4,8,8,0.8,1.15,5,9,4,2,0,0,0,3,3,3,1.0,1.22,2,4,2,1,0,0,0,1,5,5,0.64,1.09,3,5,2,1,0
Lithuania - A Lyga,Dainava,0,0,5,6,10,0.76,2.05,1,5,8,6,1,0,0,2,4,5,0.73,2.09,0,3,4,4,0,0,0,3,2,5,0.8,2.0,1,2,4,2,1
Lithuania - A Lyga,Dziugas Telsiai,0,0,5,7,9,0.81,1.0,7,10,3,0,1,0,0,2,3,5,0.7,0.9,2,7,1,0,0,0,0,3,4,4,0.91,1.09,5,3,2,0,1
Lithuania - A Lyga,Hegelmann L.,2,2,6,5,4,1.68,1.42,6,3,7,2,1,1,1,4,3,1,1.9,1.1,3,3,4,0,0,1,1,2,2,3,1.44,1.78,3,0,3,2,1
Lithuania - A Lyga,Kauno Zalgiris,2,8,3,2,5,2.05,0.5,12,6,2,0,0,1,6,0,1,2,2.3,0.5,6,3,1,0,0,1,2,3,1,3,1.8,0.5,6,3,1,0,0
Lithuania - A Lyga,Panevezys,0,5,4,8,4,1.48,1.33,7,5,5,3,1,0,2,4,3,2,1.55,1.18,5,2,2,1,1,0,3,0,5,2,1.4,1.5,2,3,3,2,0
Lithuania - A Lyga,Riteriai,0,4,2,8,7,1.14,2.1,3,4,7,3,4,0,3,1,3,4,1.27,2.18,2,2,3,1,3,0,1,1,5,3,1.0,2.0,1,2,4,2,1
Lithuania - A Lyga,Siauliai,1,2,10,2,6,1.57,1.38,6,7,4,3,1,1,1,6,0,1,2.22,1.44,3,1,3,2,0,0,1,4,2,5,1.08,1.33,3,6,1,1,1
Lithuania - A Lyga,Suduva,3,1,4,6,6,1.45,0.8,11,4,3,2,0,2,0,1,4,3,1.4,0.4,7,2,1,0,0,1,1,3,2,3,1.5,1.2,4,2,2,2,0
Lithuania - A Lyga,Zalgiris,1,2,5,6,6,1.3,1.2,7,5,5,3,0,0,1,4,3,3,1.27,0.64,6,4,0,1,0,1,1,1,3,3,1.33,1.89,1,1,5,2,0
Lithuania - 1st League,Atmosfera,1,0,2,8,4,1.13,1.33,3,8,2,0,2,1,0,1,5,2,1.33,1.56,2,4,1,0,2,0,0,1,3,2,0.83,1.0,1,4,1,0,0
Lithuania - 1st League,BFA Vilnius,1,2,5,5,2,1.67,1.07,7,2,5,0,1,0,2,3,3,0,1.88,1.0,4,0,4,0,0,1,0,2,2,2,1.43,1.14,3,2,1,0,1
Lithuania - 1st League,Babrungas,2,2,6,4,1,2.07,1.67,3,6,3,1,2,2,2,1,2,0,2.71,1.86,1,3,2,0,1,0,0,5,2,1,1.5,1.5,2,3,1,1,1
Lithuania - 1st League,Be1 NFA,1,0,2,6,6,0.93,1.67,2,6,3,3,1,0,0,0,5,2,0.71,1.29,1,4,1,1,0,1,0,2,1,4,1.13,2.0,1,2,2,2,1
Lithuania - 1st League,Ekranas,1,1,0,6,7,0.87,1.87,2,5,5,1,2,1,0,0,3,3,1.0,1.29,1,3,3,0,0,0,1,0,3,4,0.75,2.38,1,2,2,1,2
Lithuania - 1st League,Hegelmann B,1,1,2,7,4,1.2,1.73,1,7,5,0,2,1,0,1,4,2,1.25,1.75,1,3,3,0,1,0,1,1,3,2,1.14,1.71,0,4,2,0,1
Lithuania - 1st League,Jonava,0,1,1,5,8,0.67,0.73,6,7,2,0,0,0,1,0,4,2,1.0,0.86,2,4,1,0,0,0,0,1,1,6,0.38,0.63,4,3,1,0,0
Lithuania - 1st League,Kauno Z. B,1,0,4,6,4,1.27,1.87,3,2,5,4,1,1,0,3,3,0,2.0,1.43,3,0,2,2,0,0,0,1,3,4,0.63,2.25,0,2,3,2,1
Lithuania - 1st League,Minija,0,0,3,6,6,0.8,1.6,5,4,1,2,3,0,0,3,2,1,1.33,2.0,2,1,0,1,2,0,0,0,4,5,0.44,1.33,3,3,1,1,1
Lithuania - 1st League,Neptuna K.,4,2,4,3,2,2.33,0.8,7,5,2,1,0,1,1,3,2,1,2.0,0.5,5,2,1,0,0,3,1,1,1,1,2.71,1.14,2,3,1,1,0
Lithuania - 1st League,Nevezis,0,2,3,8,2,1.33,1.8,4,3,3,2,3,0,0,1,4,2,0.86,2.0,2,2,0,0,3,0,2,2,4,0,1.75,1.63,2,1,3,2,0
Lithuania - 1st League,Panevezys B,2,0,5,1,7,1.27,2.87,1,3,4,2,5,1,0,3,0,3,1.43,2.57,1,1,1,2,2,1,0,2,1,4,1.13,3.13,0,2,3,0,3
Lithuania - 1st League,Siauliai B,3,0,1,6,5,1.33,2.33,3,2,4,1,5,1,0,0,2,5,0.75,1.75,2,2,2,0,2,2,0,1,4,0,2.0,3.0,1,0,2,1,3
Lithuania - 1st League,Tauras,1,3,5,3,3,1.87,0.6,7,7,1,0,0,1,3,3,1,1,2.44,0.44,5,4,0,0,0,0,0,2,2,2,1.0,0.83,2,3,1,0,0
Lithuania - 1st League,TransINVEST,5,4,4,2,0,3.2,0.73,8,4,2,1,0,2,3,2,1,0,3.13,0.25,6,2,0,0,0,3,1,2,1,0,3.29,1.29,2,2,2,1,0
Lithuania - 1st League,Zalgiris B,4,2,4,3,2,2.2,1.47,1,8,4,2,0,2,0,4,0,1,2.29,1.86,0,3,2,2,0,2,2,0,3,1,2.13,1.13,1,5,2,0,0
Malaysia - Super League,Johor Darul,11,8,3,2,0,3.75,0.33,16,8,0,0,0,6,4,2,0,0,4.0,0.17,10,2,0,0,0,5,4,1,2,0,3.5,0.5,6,6,0,0,0
Malaysia - Super League,Kedah,0,1,4,10,9,0.88,2.13,6,6,4,3,5,0,1,3,6,2,1.25,1.58,3,4,3,1,1,0,0,1,4,7,0.5,2.67,3,2,1,2,4
Malaysia - Super League,Kelantan United,0,1,2,9,12,0.67,3.42,1,4,4,7,8,0,0,1,8,3,0.83,3.08,1,2,2,4,3,0,1,1,1,9,0.5,3.75,0,2,2,3,5
Malaysia - Super League,Kuala Lumpur,3,4,3,8,6,1.67,1.38,5,10,6,2,1,3,1,2,4,2,2.08,1.33,4,3,4,0,1,0,3,1,4,4,1.25,1.42,1,7,2,2,0
Malaysia - Super League,Kuching,0,4,8,10,2,1.58,1.17,6,10,7,0,1,0,2,4,5,1,1.58,1.08,3,5,4,0,0,0,2,4,5,1,1.58,1.25,3,5,3,0,1
Malaysia - Super League,Negeri Sembilan,0,0,8,7,9,0.96,2.04,3,4,9,5,3,0,0,3,3,6,0.75,2.25,1,2,4,3,2,0,0,5,4,3,1.17,1.83,2,2,5,2,1
Malaysia - Super League,PDRM,1,1,3,11,8,1.04,1.5,3,12,6,1,2,1,0,2,7,2,1.33,1.0,3,7,1,1,0,0,1,1,4,6,0.75,2.0,0,5,5,0,2
Malaysia - Super League,Pahang,2,2,4,10,6,1.46,1.63,5,6,8,4,1,2,1,1,5,3,1.75,1.92,2,3,3,3,1,0,1,3,5,3,1.17,1.33,3,3,5,1,0
Malaysia - Super League,Perak,1,3,5,10,5,1.5,1.5,7,6,6,3,2,1,0,3,4,4,1.42,1.83,3,2,4,1,2,0,3,2,6,1,1.58,1.17,4,4,2,2,0
Malaysia - Super League,Pulau Pinang,1,2,7,5,9,1.29,1.58,7,8,2,3,4,0,2,2,3,5,1.08,1.33,4,4,1,2,1,1,0,5,2,4,1.5,1.83,3,4,1,1,3
Malaysia - Super League,Sabah,4,2,6,6,6,1.71,1.38,5,9,7,2,1,2,0,3,5,2,1.67,1.17,3,5,3,1,0,2,2,3,1,4,1.75,1.58,2,4,4,1,1
Malaysia - Super League,Selangor,5,0,6,9,4,1.83,0.67,13,8,1,2,0,3,0,4,3,2,1.92,0.42,9,2,0,1,0,2,0,2,6,2,1.75,0.92,4,6,1,1,0
Malaysia - Super League,Terengganu,1,4,6,6,7,1.46,1.08,6,12,5,0,1,0,4,2,4,2,1.67,1.08,3,5,4,0,0,1,0,4,2,5,1.25,1.08,3,7,1,0,1
Malta - Premier League,Balzan,0,3,6,6,12,1.0,1.67,5,7,9,5,1,0,2,4,3,4,1.31,1.54,2,5,3,3,0,0,1,2,3,8,0.71,1.79,3,2,6,2,1
Malta - Premier League,Birkirkara,1,4,7,11,4,1.56,0.89,14,4,7,2,0,1,1,4,7,3,1.44,1.06,6,4,5,1,0,0,3,3,4,1,1.73,0.64,8,0,2,1,0
Malta - Premier League,Floriana,1,5,7,9,5,1.56,0.7,14,8,4,1,0,1,2,4,6,3,1.5,0.81,8,4,3,1,0,0,3,3,3,2,1.64,0.55,6,4,1,0,0
Malta - Premier League,Gzira Utd,0,2,6,10,9,1.04,1.33,7,8,9,2,1,0,1,5,4,6,1.06,1.31,4,6,4,1,1,0,1,1,6,3,1.0,1.36,3,2,5,1,0
Malta - Premier League,Hamrun Spartans,3,2,7,7,8,1.59,1.0,8,13,4,2,0,1,1,2,4,4,1.25,1.17,3,5,3,1,0,2,1,5,3,4,1.87,0.87,5,8,1,1,0
Malta - Premier League,Hibernians,1,4,7,6,9,1.33,1.26,8,8,8,2,1,0,2,3,1,6,1.08,1.33,5,1,4,1,1,1,2,4,5,3,1.53,1.2,3,7,4,1,0
Malta - Premier League,Marsaxlokk,1,5,4,11,6,1.44,1.26,7,12,6,0,2,0,1,4,5,3,1.23,1.85,0,8,3,0,2,1,4,0,6,3,1.64,0.71,7,4,3,0,0
Malta - Premier League,Melita,0,2,11,7,7,1.3,1.85,6,6,6,6,3,0,0,7,4,4,1.2,2.2,4,2,1,5,3,0,2,4,3,3,1.42,1.42,2,4,5,1,0
Malta - Premier League,Mosta,2,0,10,6,9,1.26,1.44,5,8,11,3,0,1,0,3,4,3,1.27,0.82,5,3,3,0,0,1,0,7,2,6,1.25,1.88,0,5,8,3,0
Malta - Premier League,Naxxar Lions,1,2,3,7,14,0.89,1.93,4,9,5,5,4,0,0,2,4,7,0.62,1.77,3,4,2,3,1,1,2,1,3,7,1.14,2.07,1,5,3,2,3
Malta - Premier League,Sliema,2,4,7,7,7,1.52,0.85,11,10,5,1,0,1,2,6,3,2,1.79,0.93,5,6,2,1,0,1,2,1,4,5,1.23,0.77,6,4,3,0,0
Malta - Premier League,Zabbar,1,4,4,12,6,1.33,1.63,7,6,5,8,1,0,3,0,5,3,1.27,1.82,3,1,2,5,0,1,1,4,7,3,1.38,1.5,4,5,3,3,1
Mexico - Liga MX - Apertura,A. San Luis,0,0,0,1,1,0.5,0.5,1,1,0,0,0,0,0,0,0,1,0.0,1.0,0,1,0,0,0,0,0,0,1,0,1.0,0.0,1,0,0,0,0
Mexico - Liga MX - Apertura,Atlas,0,2,0,0,0,3.0,2.5,0,0,1,1,0,0,1,0,0,0,3.0,3.0,0,0,0,1,0,0,1,0,0,0,3.0,2.0,0,0,1,0,0
Mexico - Liga MX - Apertura,CF America,0,1,0,1,0,2.0,1.0,0,2,0,0,0,0,1,0,0,0,3.0,1.0,0,1,0,0,0,0,0,0,1,0,1.0,1.0,0,1,0,0,0
Mexico - Liga MX - Apertura,Club Leon,0,0,0,1,1,0.5,0.5,1,1,0,0,0,0,0,0,1,1,0.5,0.5,1,1,0,0,0,0,0,0,0,0,,,0,0,0,0,0
Mexico - Liga MX - Apertura,Cruz Azul,0,1,0,0,1,1.5,1.5,1,0,0,1,0,0,0,0,0,1,0.0,0.0,1,0,0,0,0,0,1,0,0,0,3.0,3.0,0,0,0,1,0
Mexico - Liga MX - Apertura,Guadalajara,0,0,0,0,1,0.0,1.0,0,1,0,0,0,0,0,0,0,0,,,0,0,0,0,0,0,0,0,0,1,0.0,1.0,0,1,0,0,0
Mexico - Liga MX - Apertura,Juarez,0,0,0,1,1,0.5,1.0,0,2,0,0,0,0,0,0,1,0,1.0,1.0,0,1,0,0,0,0,0,0,0,1,0.0,1.0,0,1,0,0,0
Mexico - Liga MX - Apertura,Mazatlan,0,0,1,0,1,1.0,0.5,1,1,0,0,0,0,0,1,0,0,2.0,1.0,0,1,0,0,0,0,0,0,0,1,0.0,0.0,1,0,0,0,0
Mexico - Liga MX - Apertura,Monterrey,0,0,0,1,1,0.5,1.5,1,0,0,1,0,0,0,0,0,0,,,0,0,0,0,0,0,0,0,1,1,0.5,1.5,1,0,0,1,0
Mexico - Liga MX - Apertura,Necaxa,0,1,0,1,0,2.0,2.0,0,1,0,1,0,0,1,0,0,0,3.0,1.0,0,1,0,0,0,0,0,0,1,0,1.0,3.0,0,0,0,1,0
Mexico - Liga MX - Apertura,Pachuca,0,2,0,0,0,3.0,1.0,1,0,1,0,0,0,1,0,0,0,3.0,0.0,1,0,0,0,0,0,1,0,0,0,3.0,2.0,0,0,1,0,0
Mexico - Liga MX - Apertura,Puebla,0,0,1,1,0,1.5,2.5,0,0,1,1,0,0,0,1,0,0,2.0,3.0,0,0,0,1,0,0,0,0,1,0,1.0,2.0,0,0,1,0,0
Mexico - Liga MX - Apertura,Pumas UNAM,0,0,1,0,1,1.0,3.0,0,0,0,2,0,0,0,1,0,0,2.0,3.0,0,0,0,1,0,0,0,0,0,1,0.0,3.0,0,0,0,1,0
Mexico - Liga MX - Apertura,Queretaro,0,0,0,1,1,0.5,2.0,0,1,0,1,0,0,0,0,0,0,,,0,0,0,0,0,0,0,0,1,1,0.5,2.0,0,1,0,1,0
Mexico - Liga MX - Apertura,Santos Laguna,0,1,1,0,0,2.5,2.0,1,0,0,0,1,0,1,1,0,0,2.5,2.0,1,0,0,0,1,0,0,0,0,0,,,0,0,0,0,0
Mexico - Liga MX - Apertura,Tigres,0,0,0,1,0,1.0,0.0,1,0,0,0,0,0,0,0,1,0,1.0,0.0,1,0,0,0,0,0,0,0,0,0,,,0,0,0,0,0
Mexico - Liga MX - Apertura,Tijuana,0,0,0,2,0,1.0,1.5,1,0,0,1,0,0,0,0,1,0,1.0,0.0,1,0,0,0,0,0,0,0,1,0,1.0,3.0,0,0,0,1,0
Mexico - Liga MX - Apertura,Toluca,1,1,0,0,0,3.5,1.5,0,1,1,0,0,0,1,0,0,0,3.0,1.0,0,1,0,0,0,1,0,0,0,0,4.0,2.0,0,0,1,0,0
Mexico - Liga MX - Clausura,A. San Luis,0,2,4,6,5,1.18,1.94,1,6,3,7,0,0,1,3,3,2,1.33,1.67,1,4,1,3,0,0,1,1,3,3,1.0,2.25,0,2,2,4,0
Mexico - Liga MX - Clausura,Atlas,1,3,3,6,4,1.47,1.88,2,5,4,5,1,0,3,1,4,1,1.67,2.22,0,3,2,3,1,1,0,2,2,3,1.25,1.5,2,2,2,2,0
Mexico - Liga MX - Clausura,CF America,3,4,3,3,4,2.0,0.59,9,7,0,1,0,2,3,1,2,1,2.44,0.56,6,2,0,1,0,1,1,2,1,3,1.5,0.63,3,5,0,0,0
Mexico - Liga MX - Clausura,Club Leon,0,1,6,9,1,1.41,1.24,3,8,5,1,0,0,1,2,4,1,1.38,1.13,3,2,2,1,0,0,0,4,5,0,1.44,1.33,0,6,3,0,0
Mexico - Liga MX - Clausura,Cruz Azul,0,4,3,8,2,1.53,0.94,5,8,4,0,0,0,2,2,4,0,1.75,0.88,2,5,1,0,0,0,2,1,4,2,1.33,1.0,3,3,3,0,0
Mexico - Liga MX - Clausura,Guadalajara,0,0,3,12,2,1.06,1.24,4,8,2,3,0,0,0,2,4,2,1.0,0.63,3,5,0,0,0,0,0,1,8,0,1.11,1.78,1,3,2,3,0
Mexico - Liga MX - Clausura,Juarez,0,0,5,6,6,0.94,1.24,5,7,3,0,2,0,0,4,3,2,1.22,1.33,3,2,3,0,1,0,0,1,3,4,0.63,1.13,2,5,0,0,1
Mexico - Liga MX - Clausura,Mazatlan,0,1,1,11,4,0.94,1.53,2,8,5,1,1,0,1,1,6,1,1.22,1.22,1,5,3,0,0,0,0,0,5,3,0.63,1.88,1,3,2,1,1
Mexico - Liga MX - Clausura,Monterrey,2,4,2,8,1,1.88,1.35,3,7,5,2,0,1,2,1,4,0,2.0,1.25,2,3,2,1,0,1,2,1,4,1,1.78,1.44,1,4,3,1,0
Mexico - Liga MX - Clausura,Necaxa,1,6,5,4,1,2.12,1.71,4,4,6,1,2,0,4,2,2,0,2.25,2.0,1,2,3,1,1,1,2,3,2,1,2.0,1.44,3,2,3,0,1
Mexico - Liga MX - Clausura,Pachuca,2,1,5,7,2,1.71,1.35,4,5,6,2,0,1,0,3,3,2,1.44,0.78,3,5,1,0,0,1,1,2,4,0,2.0,2.0,1,0,5,2,0
Mexico - Liga MX - Clausura,Puebla,0,0,3,6,8,0.71,1.47,3,6,5,3,0,0,0,1,3,4,0.63,1.5,2,2,2,2,0,0,0,2,3,4,0.78,1.44,1,4,3,1,0
Mexico - Liga MX - Clausura,Pumas UNAM,0,2,6,5,4,1.35,1.53,4,5,4,3,1,0,0,2,3,4,0.78,0.89,4,3,1,1,0,0,2,4,2,0,2.0,2.25,0,2,3,2,1
Mexico - Liga MX - Clausura,Queretaro,0,1,4,6,6,1.0,1.41,4,7,4,0,2,0,1,2,4,2,1.22,1.22,3,3,2,0,1,0,0,2,2,4,0.75,1.63,1,4,2,0,1
Mexico - Liga MX - Clausura,Santos Laguna,0,0,5,5,7,0.88,2.12,1,5,5,3,3,0,0,3,2,3,1.0,2.13,1,2,2,1,2,0,0,2,3,4,0.78,2.11,0,3,3,2,1
Mexico - Liga MX - Clausura,Tigres,1,2,6,2,6,1.41,0.82,5,11,0,1,0,1,1,5,1,1,2.0,0.67,3,6,0,0,0,0,1,1,1,5,0.75,1.0,2,5,0,1,0
Mexico - Liga MX - Clausura,Tijuana,2,1,6,6,2,1.71,2.06,2,4,6,1,4,1,1,4,2,0,2.13,2.38,0,2,3,1,2,1,0,2,4,2,1.33,1.78,2,2,3,0,2
Mexico - Liga MX - Clausura,Toluca,4,4,3,5,1,2.41,1.29,5,4,6,2,0,2,1,3,2,0,2.63,1.13,2,3,3,0,0,2,3,0,3,1,2.22,1.44,3,1,3,2,0
Netherlands - Eredivisie,AZ Alkmaar,1,5,11,12,5,1.71,1.09,12,10,9,3,0,1,1,4,10,1,1.76,1.0,6,5,6,0,0,0,4,7,2,4,1.65,1.18,6,5,3,3,0
Netherlands - Eredivisie,Ajax Amsterdam,3,4,17,8,2,1.97,0.94,16,8,7,2,1,2,4,7,3,1,2.24,0.82,8,5,3,1,0,1,0,10,5,1,1.71,1.06,8,3,4,1,1
Netherlands - Eredivisie,Almere City,0,1,4,12,17,0.68,1.88,7,10,7,5,5,0,1,1,8,7,0.76,2.12,3,6,2,2,4,0,0,3,4,10,0.59,1.65,4,4,5,3,1
Netherlands - Eredivisie,FC Groningen,3,1,5,13,12,1.18,1.56,7,14,6,4,3,3,0,4,5,5,1.59,0.82,7,7,2,1,0,0,1,1,8,7,0.76,2.29,0,7,4,3,3
Netherlands - Eredivisie,FC Twente,3,2,13,14,2,1.82,1.44,11,8,10,3,2,2,1,8,6,0,2.12,1.24,8,3,3,2,1,1,1,5,8,2,1.53,1.65,3,5,7,1,1
Netherlands - Eredivisie,FC Utrecht,3,7,11,7,6,1.82,1.32,9,13,8,2,2,1,4,4,4,4,1.65,1.41,6,5,3,1,2,2,3,7,3,2,2.0,1.24,3,8,5,1,0
Netherlands - Eredivisie,Feyenoord,8,5,8,8,5,2.24,1.12,10,12,10,2,0,3,4,5,3,2,2.24,1.06,6,5,5,1,0,5,1,3,5,3,2.24,1.18,4,7,5,1,0
Netherlands - Eredivisie,Fortuna Sittard,1,3,4,15,11,1.09,1.59,10,8,7,5,4,0,3,0,8,6,1.0,1.41,8,0,4,4,1,1,0,4,7,5,1.18,1.76,2,8,3,1,3
Netherlands - Eredivisie,Go Ahead Eagles,2,6,11,8,7,1.68,1.62,9,8,9,5,3,2,2,6,5,2,1.88,1.29,6,4,5,1,1,0,4,5,3,5,1.47,1.94,3,4,4,4,2
Netherlands - Eredivisie,Heerenveen,2,3,6,13,10,1.24,1.68,6,13,7,7,1,1,3,5,7,1,1.76,0.88,6,8,2,1,0,1,0,1,6,9,0.71,2.47,0,5,5,6,1
Netherlands - Eredivisie,Heracles Almelo,2,1,9,13,9,1.24,1.85,6,13,5,2,8,2,1,5,8,1,1.71,1.59,3,6,5,1,2,0,0,4,5,8,0.76,2.12,3,7,0,1,6
Netherlands - Eredivisie,NAC Breda,1,0,7,16,10,1.0,1.71,5,14,6,5,4,1,0,3,11,2,1.24,1.29,4,8,2,2,1,0,0,4,5,8,0.76,2.12,1,6,4,3,3
Netherlands - Eredivisie,NEC Nijmegen,2,7,4,12,9,1.5,1.35,10,10,9,3,2,2,4,3,8,0,2.12,1.41,4,5,5,3,0,0,3,1,4,9,0.88,1.29,6,5,4,0,2
Netherlands - Eredivisie,PEC Zwolle,1,5,6,12,10,1.26,1.5,6,17,6,1,4,0,4,2,8,3,1.41,1.18,5,8,2,1,1,1,1,4,4,7,1.12,1.82,1,9,4,0,3
Netherlands - Eredivisie,PSV Eindhoven,9,12,9,2,2,3.03,1.15,9,15,6,4,0,7,3,5,1,1,3.24,0.88,6,7,4,0,0,2,9,4,1,1,2.82,1.41,3,8,2,4,0
Netherlands - Eredivisie,RKC Waalwijk,3,1,8,11,11,1.29,2.18,4,5,13,8,4,2,1,4,4,6,1.47,1.82,4,2,5,5,1,1,0,4,7,5,1.12,2.53,0,3,8,3,3
Netherlands - Eredivisie,Sparta,1,3,5,16,9,1.15,1.26,6,17,8,2,1,1,1,2,9,4,1.18,1.41,4,5,6,1,1,0,2,3,7,5,1.12,1.12,2,12,2,1,0
Netherlands - Eredivisie,Willem II,1,1,6,15,11,1.0,1.65,5,12,11,4,2,1,1,3,7,5,1.18,1.59,3,3,9,2,0,0,0,3,8,6,0.82,1.71,2,9,2,2,2
Netherlands - Eerste Divisie,ADO Den Haag,4,5,10,14,5,1.82,1.24,9,18,7,2,2,0,4,7,6,2,1.68,1.32,5,9,2,1,2,4,1,3,8,3,1.95,1.16,4,9,5,1,0
Netherlands - Eerste Divisie,Cambuur,5,3,8,15,7,1.66,1.11,15,11,7,3,2,1,2,4,8,4,1.42,0.95,7,7,4,1,0,4,1,4,7,3,1.89,1.26,8,4,3,2,2
Netherlands - Eerste Divisie,De Graafschap,7,3,14,7,7,1.92,1.32,9,14,9,6,0,5,3,7,2,2,2.42,1.0,7,7,3,2,0,2,0,7,5,5,1.42,1.63,2,7,6,4,0
Netherlands - Eerste Divisie,Excelsior,5,8,8,12,5,1.95,1.0,14,14,6,4,0,3,5,4,5,2,2.16,0.74,10,5,3,1,0,2,3,4,7,3,1.74,1.26,4,9,3,3,0
Netherlands - Eerste Divisie,FC Den Bosch,3,4,9,9,13,1.39,1.26,14,10,7,5,2,2,2,5,6,4,1.68,1.0,8,5,4,2,0,1,2,4,3,9,1.11,1.53,6,5,3,3,2
Netherlands - Eerste Divisie,FC Dordrecht,4,9,8,10,7,1.82,1.21,13,11,10,2,2,4,6,6,3,0,2.58,0.89,8,6,4,1,0,0,3,2,7,7,1.05,1.53,5,5,6,1,2
Netherlands - Eerste Divisie,FC Eindhoven,4,5,8,11,10,1.53,1.68,12,3,12,7,4,1,2,3,7,6,1.21,1.89,6,1,4,5,3,3,3,5,4,4,1.84,1.47,6,2,8,2,1
Netherlands - Eerste Divisie,FC Emmen,3,6,8,10,11,1.47,1.39,10,12,9,5,2,2,3,3,7,4,1.58,1.47,5,5,5,3,1,1,3,5,3,7,1.37,1.32,5,7,4,2,1
Netherlands - Eerste Divisie,FC Volendam,6,11,12,6,3,2.29,1.26,12,13,8,1,4,5,6,5,2,1,2.63,1.05,8,6,3,0,2,1,5,7,4,2,1.95,1.47,4,7,5,1,2
Netherlands - Eerste Divisie,Helmond Sport,1,6,8,15,8,1.39,1.61,7,15,6,6,4,1,3,5,7,3,1.58,1.26,5,9,2,1,2,0,3,3,8,5,1.21,1.95,2,6,4,5,2
Netherlands - Eerste Divisie,Jong AZ,4,5,12,11,6,1.82,1.66,8,12,9,6,3,2,3,8,3,3,2.05,1.58,2,9,3,5,0,2,2,4,8,3,1.58,1.74,6,3,6,1,3
Netherlands - Eerste Divisie,Jong Ajax,1,4,5,11,17,0.97,1.37,10,10,13,4,1,1,3,1,5,9,1.05,0.89,8,5,6,0,0,0,1,4,6,8,0.89,1.84,2,5,7,4,1
Netherlands - Eerste Divisie,Jong PSV,1,4,13,11,9,1.45,2.26,3,8,12,7,8,1,2,7,7,2,1.74,2.53,0,2,9,4,4,0,2,6,4,7,1.16,2.0,3,6,3,3,4
Netherlands - Eerste Divisie,Jong Utrecht,1,1,4,16,16,0.82,2.16,4,10,9,10,5,1,1,1,8,8,0.89,1.79,3,6,4,4,2,0,0,3,8,8,0.74,2.53,1,4,5,6,3
Netherlands - Eerste Divisie,MVV Maastricht,3,4,8,9,14,1.37,1.55,9,11,10,4,4,3,2,6,5,3,2.0,1.26,6,4,8,0,1,0,2,2,4,11,0.74,1.84,3,7,2,4,3
Netherlands - Eerste Divisie,Roda JC,0,8,5,15,10,1.29,1.5,11,12,5,7,3,0,5,2,7,5,1.37,1.05,8,7,1,1,2,0,3,3,8,5,1.21,1.95,3,5,4,6,1
Netherlands - Eerste Divisie,TOP Oss,0,1,9,10,18,0.82,1.61,8,13,9,3,5,0,1,5,7,6,1.05,1.63,4,7,4,1,3,0,0,4,3,12,0.58,1.58,4,6,5,2,2
Netherlands - Eerste Divisie,Telstar,5,6,8,12,7,1.82,1.24,15,8,8,6,1,4,5,3,4,3,2.32,0.84,11,2,4,2,0,1,1,5,8,4,1.32,1.63,4,6,4,4,1
Netherlands - Eerste Divisie,VVV,4,3,4,11,16,1.16,1.82,7,12,9,5,5,1,2,3,6,7,1.16,1.58,4,7,5,2,1,3,1,1,5,9,1.16,2.05,3,5,4,3,4
Netherlands - Eerste Divisie,Vitesse Arnhem,1,5,12,11,9,1.42,1.92,8,9,8,8,5,0,2,7,6,4,1.37,1.63,5,6,3,3,2,1,3,5,5,5,1.47,2.21,3,3,5,5,3
Northern Ireland - NIFL Premiership,Ballymena Utd,3,4,4,14,13,1.24,1.42,9,11,14,2,2,2,2,2,6,6,1.39,1.33,3,7,7,1,0,1,2,2,8,7,1.1,1.5,6,4,7,1,2
Northern Ireland - NIFL Premiership,Carrick Rangers,1,1,6,13,17,0.84,1.55,10,12,4,9,3,1,1,4,5,9,1.0,1.2,9,5,1,3,2,0,0,2,8,8,0.67,1.94,1,7,3,6,1
Northern Ireland - NIFL Premiership,Cliftonville,5,3,9,9,12,1.53,1.08,13,12,10,3,0,2,2,5,5,4,1.67,0.61,12,2,3,1,0,3,1,4,4,8,1.4,1.5,1,10,7,2,0
Northern Ireland - NIFL Premiership,Coleraine,3,4,7,17,7,1.45,1.32,11,8,15,4,0,2,2,5,6,4,1.58,1.32,5,4,9,1,0,1,2,2,11,3,1.32,1.32,6,4,6,3,0
Northern Ireland - NIFL Premiership,Crusaders,1,4,8,15,10,1.24,1.39,11,13,5,7,2,0,4,6,6,4,1.5,1.8,3,7,4,4,2,1,0,2,9,6,0.94,0.94,8,6,1,3,0
Northern Ireland - NIFL Premiership,Dungannon,2,3,8,17,8,1.34,1.26,13,12,5,6,2,1,2,4,9,4,1.35,1.25,7,7,1,4,1,1,1,4,8,4,1.33,1.28,6,5,4,2,1
Northern Ireland - NIFL Premiership,Glenavon,1,5,8,7,17,1.11,1.24,10,15,7,6,0,0,3,5,3,8,1.16,1.26,3,11,2,3,0,1,2,3,4,9,1.05,1.21,7,4,5,3,0
Northern Ireland - NIFL Premiership,Glentoran,1,5,11,8,13,1.29,0.97,14,13,9,2,0,0,1,4,5,7,0.94,0.76,9,4,3,1,0,1,4,7,3,6,1.57,1.14,5,9,6,1,0
Northern Ireland - NIFL Premiership,Larne,1,2,12,12,11,1.21,0.87,11,22,4,1,0,0,0,6,5,7,0.94,0.83,5,12,0,1,0,1,2,6,7,4,1.45,0.9,6,10,4,0,0
Northern Ireland - NIFL Premiership,Linfield,1,11,11,9,6,1.82,0.74,18,13,6,1,0,1,4,7,6,2,1.85,0.75,9,8,2,1,0,0,7,4,3,4,1.78,0.72,9,5,4,0,0
Northern Ireland - NIFL Premiership,Loughgall,0,3,7,13,15,0.95,2.24,5,7,12,5,9,0,2,5,6,6,1.16,2.37,2,3,6,3,5,0,1,2,7,9,0.74,2.11,3,4,6,2,4
Northern Ireland - NIFL Premiership,Portadown,0,3,12,15,8,1.26,1.18,12,11,12,2,1,0,1,8,9,2,1.4,0.95,7,8,4,1,0,0,2,4,6,6,1.11,1.44,5,3,8,1,1
Norway - Eliteserien,Bodo/Glimt,3,3,3,5,0,2.29,0.93,8,1,4,0,1,1,3,2,1,0,2.57,0.86,5,0,1,0,1,2,0,1,4,0,2.0,1.0,3,1,3,0,0
Norway - Eliteserien,Brann,2,3,4,2,5,1.69,1.5,3,5,5,3,0,1,3,2,1,2,2.0,1.33,2,3,3,1,0,1,0,2,1,3,1.29,1.71,1,2,2,2,0
Norway - Eliteserien,Bryne,1,2,2,6,3,1.43,1.71,2,5,2,5,0,1,2,0,2,2,1.71,1.57,1,3,1,2,0,0,0,2,4,1,1.14,1.86,1,2,1,3,0
Norway - Eliteserien,Fredrikstad,1,3,1,5,6,1.25,1.13,5,7,2,1,1,1,2,1,2,3,1.56,0.89,3,4,2,0,0,0,1,0,3,3,0.86,1.43,2,3,0,1,1
Norway - Eliteserien,HamKam,0,1,3,5,5,1.0,1.79,2,6,2,2,2,0,0,3,3,1,1.29,1.71,1,4,0,1,1,0,1,0,2,4,0.71,1.86,1,2,2,1,1
Norway - Eliteserien,Haugesund,0,0,0,5,10,0.33,2.6,2,2,3,3,5,0,0,0,1,6,0.14,2.43,2,0,2,0,3,0,0,0,4,4,0.5,2.75,0,2,1,3,2
Norway - Eliteserien,KFUM Oslo,1,2,2,5,4,1.43,1.36,4,5,1,4,0,1,1,1,3,1,1.86,1.29,2,3,0,2,0,0,1,1,2,3,1.0,1.43,2,2,1,2,0
Norway - Eliteserien,Kristiansund,1,1,3,5,6,1.13,1.63,3,7,3,1,2,1,0,1,1,4,1.0,1.0,1,5,1,0,0,0,1,2,4,2,1.22,2.11,2,2,2,1,2
Norway - Eliteserien,Molde,1,3,4,1,6,1.47,1.53,3,5,4,2,1,1,0,3,0,3,1.43,1.57,0,4,2,1,0,0,3,1,1,3,1.5,1.5,3,1,2,1,1
Norway - Eliteserien,Rosenborg,0,1,5,6,4,1.19,1.0,8,4,2,0,2,0,1,1,5,1,1.25,0.38,5,3,0,0,0,0,0,4,1,3,1.13,1.63,3,1,2,0,2
Norway - Eliteserien,Sandefjord,2,2,4,4,2,2.0,1.29,6,2,2,4,0,2,2,3,0,0,3.14,0.43,5,1,1,0,0,0,0,1,4,2,0.86,2.14,1,1,1,4,0
Norway - Eliteserien,Sarpsborg 08,1,2,5,3,3,1.64,1.0,4,7,2,1,0,1,1,2,2,1,1.86,1.29,1,4,1,1,0,0,1,3,1,2,1.43,0.71,3,3,1,0,0
Norway - Eliteserien,Stromsgodset,1,1,2,5,5,1.21,2.36,1,1,7,3,2,0,0,1,3,3,0.71,2.29,0,0,5,2,0,1,1,1,2,2,1.71,2.43,1,1,2,1,2
Norway - Eliteserien,Tromso,1,4,3,5,1,1.93,1.29,4,6,1,2,1,0,1,3,2,1,1.57,1.0,2,4,0,1,0,1,3,0,3,0,2.29,1.57,2,2,1,1,1
Norway - Eliteserien,Valerenga,0,2,4,6,3,1.33,1.33,4,5,4,1,1,0,2,2,2,1,1.71,1.71,1,3,1,1,1,0,0,2,4,2,1.0,1.0,3,2,3,0,0
Norway - Eliteserien,Viking,5,4,1,6,1,2.47,1.41,5,6,2,2,2,2,4,1,1,1,2.67,1.33,3,4,0,0,2,3,0,0,5,0,2.25,1.5,2,2,2,2,0
Norway - 1st Division,Aalesund,1,1,4,4,3,1.46,1.31,4,3,4,2,0,0,1,3,2,1,1.57,0.86,3,2,2,0,0,1,0,1,2,2,1.33,1.83,1,1,2,2,0
Norway - 1st Division,Asane,0,1,5,3,4,1.23,1.46,1,6,5,1,0,0,0,3,1,2,1.17,1.0,1,4,1,0,0,0,1,2,2,2,1.29,1.86,0,2,4,1,0
Norway - 1st Division,Egersund,2,3,3,3,2,2.0,1.69,2,3,6,1,1,1,2,2,0,1,2.33,2.5,0,0,4,1,1,1,1,1,3,1,1.71,1.0,2,3,2,0,0
Norway - 1st Division,Hodd,0,2,3,5,3,1.31,1.69,1,7,3,1,1,0,2,2,0,2,1.67,1.33,0,4,2,0,0,0,0,1,5,1,1.0,2.0,1,3,1,1,1
Norway - 1st Division,Kongsvinger,3,1,5,3,1,2.31,1.38,3,3,6,1,0,2,1,2,2,0,2.71,1.29,2,2,2,1,0,1,0,3,1,1,1.83,1.5,1,1,4,0,0
Norway - 1st Division,Lillestrom,2,2,4,4,1,2.15,0.54,9,1,3,0,0,0,1,2,2,1,1.5,0.33,5,0,1,0,0,2,1,2,2,0,2.71,0.71,4,1,2,0,0
Norway - 1st Division,Lyn,0,2,2,5,4,1.15,1.38,1,7,4,1,0,0,1,1,2,3,1.0,1.43,0,5,1,1,0,0,1,1,3,1,1.33,1.33,1,2,3,0,0
Norway - 1st Division,Mjondalen,0,1,3,5,4,1.08,2.54,1,4,1,3,4,0,0,2,3,1,1.17,3.33,0,1,1,1,3,0,1,1,2,3,1.0,1.86,1,3,0,2,1
Norway - 1st Division,Moss,1,1,6,1,4,1.54,2.23,2,2,4,3,2,1,1,4,0,1,2.14,1.57,2,2,1,1,1,0,0,2,1,3,0.83,3.0,0,0,3,2,1
Norway - 1st Division,Odd,0,1,5,5,2,1.38,1.23,2,8,1,2,0,0,0,4,3,0,1.57,0.86,2,4,1,0,0,0,1,1,2,2,1.17,1.67,0,4,0,2,0
Norway - 1st Division,Ranheim,2,0,3,4,4,1.38,1.69,1,6,3,2,1,0,0,2,2,3,0.86,1.86,0,4,1,1,1,2,0,1,2,1,2.0,1.5,1,2,2,1,0
Norway - 1st Division,Raufoss,1,2,3,5,2,1.77,1.46,2,5,4,2,0,1,2,0,2,2,2.0,1.0,2,3,2,0,0,0,0,3,3,0,1.5,2.0,0,2,2,2,0
Norway - 1st Division,Skeid,1,1,0,10,1,1.31,2.08,0,6,3,1,3,0,0,0,6,0,1.0,2.33,0,3,0,1,2,1,1,0,4,1,1.57,1.86,0,3,3,0,1
Norway - 1st Division,Sogndal,1,2,5,4,1,1.85,1.54,4,2,5,0,2,0,2,2,2,0,2.0,1.67,2,0,3,0,1,1,0,3,2,1,1.71,1.43,2,2,2,0,1
Norway - 1st Division,Stabaek,1,0,3,7,2,1.31,1.85,3,3,3,2,2,1,0,1,4,1,1.43,1.57,2,1,2,2,0,0,0,2,3,1,1.17,2.17,1,2,1,0,2
Norway - 1st Division,Start,1,3,4,4,1,2.0,1.15,3,6,3,1,0,1,0,3,2,0,2.17,1.5,0,4,1,1,0,0,3,1,2,1,1.86,0.86,3,2,2,0,0
Norway - Division 3,Arendal,3,2,0,8,1,2.14,1.36,1,9,2,2,0,2,2,0,3,0,3.0,1.43,1,4,0,2,0,1,0,0,5,1,1.29,1.29,0,5,2,0,0
Norway - Division 3,Brann B,3,0,5,3,3,1.79,2.64,0,2,5,5,2,2,0,3,0,2,2.0,2.43,0,1,3,2,1,1,0,2,3,1,1.57,2.86,0,1,2,3,1
Norway - Division 3,Brattvag,2,4,5,2,1,2.29,2.07,2,5,1,3,3,1,2,4,0,0,2.57,1.86,2,2,0,2,1,1,2,1,2,1,2.0,2.29,0,3,1,1,2
Norway - Division 3,Eik Tonsberg,1,1,4,6,2,1.5,1.57,4,5,1,1,3,1,1,1,3,1,1.71,1.0,3,3,0,0,1,0,0,3,3,1,1.29,2.14,1,2,1,1,2
Norway - Division 3,Flekkeroy,0,5,1,4,4,1.5,2.21,2,4,3,2,3,0,2,1,3,1,1.57,1.29,1,3,3,0,0,0,3,0,1,3,1.43,3.14,1,1,0,2,3
Norway - Division 3,Jerv,2,2,3,6,1,1.86,1.57,1,6,5,2,0,1,0,2,4,0,1.71,1.29,1,4,1,1,0,1,2,1,2,1,2.0,1.86,0,2,4,1,0
Norway - Division 3,Lysekloster,1,2,1,6,4,1.29,1.43,5,1,6,1,1,0,2,1,2,2,1.43,1.0,3,1,3,0,0,1,0,0,4,2,1.14,1.86,2,0,3,1,1
Norway - Division 3,Notodden,0,2,4,4,4,1.29,1.79,3,6,1,2,2,0,1,3,2,1,1.57,1.43,2,3,0,1,1,0,1,1,2,3,1.0,2.14,1,3,1,1,1
Norway - Division 3,Pors Grenland,1,1,2,8,2,1.36,1.64,3,4,4,1,2,0,0,1,4,2,0.86,1.0,2,3,2,0,0,1,1,1,4,0,1.86,2.29,1,1,2,1,2
Norway - Division 3,Sandnes Ulf,4,4,3,2,1,2.93,1.07,4,6,3,1,0,2,2,1,1,1,3.0,0.57,3,4,0,0,0,2,2,2,1,0,2.86,1.57,1,2,3,1,0
Norway - Division 3,Sandviken,1,0,4,8,1,1.5,2.29,0,5,5,2,2,1,0,2,4,0,1.86,1.71,0,3,3,1,0,0,0,2,4,1,1.14,2.86,0,2,2,1,2
Norway - Division 3,Sotra,2,0,8,3,1,2.07,0.93,5,6,2,1,0,2,0,3,2,0,2.57,1.43,1,3,2,1,0,0,0,5,1,1,1.57,0.43,4,3,0,0,0
Norway - Division 3,Traef,0,2,2,6,4,1.14,1.71,1,6,4,2,1,0,2,1,4,0,1.71,1.86,1,2,2,1,1,0,0,1,2,4,0.57,1.57,0,4,2,1,0
Norway - Division 3,V. Haugesund,2,0,6,4,2,1.71,2.07,0,5,6,0,3,2,0,3,1,1,2.14,2.71,0,1,3,0,3,0,0,3,3,1,1.29,1.43,0,4,3,0,0
North Macedonia - First League,Besa,1,3,6,9,14,1.03,1.61,7,12,6,5,3,0,2,5,4,5,1.25,1.44,5,5,2,3,1,1,1,1,5,9,0.82,1.76,2,7,4,2,2
North Macedonia - First League,Brera Strumica,2,5,2,14,10,1.24,1.7,6,8,12,4,3,2,4,0,4,6,1.5,1.44,3,5,6,2,0,0,1,2,10,4,1.0,1.94,3,3,6,2,3
North Macedonia - First League,Gostivar,2,2,6,11,12,1.12,1.0,14,9,6,4,0,2,2,2,5,6,1.35,1.0,7,5,3,2,0,0,0,4,6,6,0.88,1.0,7,4,3,2,0
North Macedonia - First League,Pelister,0,3,1,15,14,0.79,1.15,14,9,4,3,3,0,1,0,10,5,0.81,0.75,10,3,1,1,1,0,2,1,5,9,0.76,1.53,4,6,3,2,2
North Macedonia - First League,Rabotnicki,1,3,7,10,12,1.12,0.67,16,13,3,1,0,1,2,3,6,5,1.29,0.53,9,7,1,0,0,0,1,4,4,7,0.94,0.81,7,6,2,1,0
North Macedonia - First League,Shkendija,5,4,7,12,5,1.79,0.91,15,11,2,5,0,5,1,5,5,1,2.29,1.0,7,6,1,3,0,0,3,2,7,4,1.25,0.81,8,5,1,2,0
North Macedonia - First League,Shkupi,0,10,4,9,10,1.42,1.42,8,11,7,6,1,0,6,2,4,5,1.53,1.24,3,9,3,2,0,0,4,2,5,5,1.31,1.63,5,2,4,4,1
North Macedonia - First League,Sileks,5,4,7,9,8,1.73,0.58,18,13,1,0,1,3,2,2,7,3,1.76,0.53,9,7,1,0,0,2,2,5,2,5,1.69,0.63,9,6,0,0,1
North Macedonia - First League,Struga,2,2,5,17,7,1.24,1.12,12,12,3,5,1,1,1,3,9,3,1.29,0.94,8,5,2,1,1,1,1,2,8,4,1.19,1.31,4,7,1,4,0
North Macedonia - First League,Tikves,0,2,5,9,17,0.76,0.94,11,16,3,3,0,0,1,4,3,8,0.88,0.81,7,6,2,1,0,0,1,1,6,9,0.65,1.06,4,10,1,2,0
North Macedonia - First League,Vardar,0,5,5,12,11,1.12,1.12,13,10,5,3,2,0,3,1,6,6,1.06,1.25,5,5,4,1,1,0,2,4,6,5,1.18,1.0,8,5,1,2,1
North Macedonia - First League,Voska Sport,0,4,2,9,18,0.76,1.91,4,12,5,8,4,0,2,1,4,9,0.75,1.5,3,6,3,4,0,0,2,1,5,9,0.76,2.29,1,6,2,4,4
Paraguay - Primera Div. - Apertura,2 de Mayo,0,0,1,13,8,0.68,1.18,5,12,3,0,2,0,0,0,5,6,0.45,1.45,2,6,1,0,2,0,0,1,8,2,0.91,0.91,3,6,2,0,0
Paraguay - Primera Div. - Apertura,A. Tembetary,0,0,2,13,7,0.77,1.41,5,9,5,2,1,0,0,2,8,1,1.09,1.82,2,3,4,1,1,0,0,0,5,6,0.45,1.0,3,6,1,1,0
Paraguay - Primera Div. - Apertura,Cerro Porteno,1,3,5,8,5,1.5,0.82,7,12,3,0,0,0,1,4,4,2,1.36,0.82,4,5,2,0,0,1,2,1,4,3,1.64,0.82,3,7,1,0,0
Paraguay - Primera Div. - Apertura,D. Recoleta,1,3,3,10,5,1.32,1.41,4,10,5,2,1,0,1,0,7,3,0.91,1.45,1,6,2,2,0,1,2,3,3,2,1.73,1.36,3,4,3,0,1
Paraguay - Primera Div. - Apertura,G. Caballero,0,2,2,9,9,0.86,1.18,8,8,3,1,2,0,1,2,4,4,1.0,1.45,3,5,1,0,2,0,1,0,5,5,0.73,0.91,5,3,2,1,0
Paraguay - Primera Div. - Apertura,Guarani,0,2,7,7,6,1.23,1.09,7,9,3,3,0,0,0,4,3,4,1.0,1.55,1,6,1,3,0,0,2,3,4,2,1.45,0.64,6,3,2,0,0
Paraguay - Primera Div. - Apertura,Libertad,2,2,4,11,3,1.59,0.68,11,8,2,1,0,1,1,2,6,1,1.64,0.73,6,3,1,1,0,1,1,2,5,2,1.55,0.64,5,5,1,0,0
Paraguay - Primera Div. - Apertura,Nacional,2,0,1,13,6,1.05,1.27,6,7,6,3,0,1,0,0,8,2,1.09,1.09,4,4,1,2,0,1,0,1,5,4,1.0,1.45,2,3,5,1,0
Paraguay - Primera Div. - Apertura,Olimpia,1,2,4,9,6,1.23,1.0,6,11,4,1,0,1,2,2,1,5,1.36,1.0,3,6,1,1,0,0,0,2,8,1,1.09,1.0,3,5,3,0,0
Paraguay - Primera Div. - Apertura,S. Ameliano,1,1,6,4,10,1.05,0.91,7,10,5,0,0,0,0,5,2,4,1.09,0.91,4,4,3,0,0,1,1,1,2,6,1.0,0.91,3,6,2,0,0
Paraguay - Primera Div. - Apertura,S. Luqueno,0,0,2,9,11,0.59,1.14,8,8,2,3,1,0,0,1,4,6,0.55,0.45,6,5,0,0,0,0,0,1,5,5,0.64,1.82,2,3,2,3,1
Paraguay - Primera Div. - Apertura,S. Trinidense,0,1,6,12,3,1.23,1.0,5,14,2,0,1,0,0,3,7,1,1.18,0.73,4,6,1,0,0,0,1,3,5,2,1.27,1.27,1,8,1,0,1
Paraguay - Primera Div. - Clausura,2 de Mayo,0,0,0,2,1,0.67,1.0,2,0,0,1,0,0,0,0,0,1,0.0,0.0,1,0,0,0,0,0,0,0,2,0,1.0,1.5,1,0,0,1,0
Paraguay - Primera Div. - Clausura,A. Tembetary,0,0,1,1,1,1.0,2.33,0,1,0,2,0,0,0,1,0,0,2.0,3.0,0,0,0,1,0,0,0,0,1,1,0.5,2.0,0,1,0,1,0
Paraguay - Primera Div. - Clausura,Cerro Porteno,0,1,0,1,1,1.33,0.33,2,1,0,0,0,0,1,0,0,1,1.5,0.5,1,1,0,0,0,0,0,0,1,0,1.0,0.0,1,0,0,0,0
Paraguay - Primera Div. - Clausura,D. Recoleta,0,2,1,0,0,2.67,2.33,0,1,1,0,1,0,1,1,0,0,2.5,2.5,0,1,0,0,1,0,1,0,0,0,3.0,2.0,0,0,1,0,0
Paraguay - Primera Div. - Clausura,G. Caballero,0,0,0,1,2,0.33,2.0,0,1,1,1,0,0,0,0,0,1,0.0,1.0,0,1,0,0,0,0,0,0,1,1,0.5,2.5,0,0,1,1,0
Paraguay - Primera Div. - Clausura,Guarani,0,1,0,0,2,1.0,0.67,1,2,0,0,0,0,1,0,0,1,1.5,0.5,1,1,0,0,0,0,0,0,0,1,0.0,1.0,0,1,0,0,0
Paraguay - Primera Div. - Clausura,Libertad,0,0,0,0,3,0.0,0.67,1,2,0,0,0,0,0,0,0,2,0.0,1.0,0,2,0,0,0,0,0,0,0,1,0.0,0.0,1,0,0,0,0
Paraguay - Primera Div. - Clausura,Nacional,0,0,0,3,0,1.0,0.33,2,1,0,0,0,0,0,0,1,0,1.0,0.0,1,0,0,0,0,0,0,0,2,0,1.0,0.5,1,1,0,0,0
Paraguay - Primera Div. - Clausura,Olimpia,0,2,0,1,0,2.33,2.0,0,2,0,0,1,0,1,0,1,0,2.0,1.0,0,2,0,0,0,0,1,0,0,0,3.0,4.0,0,0,0,0,1
Paraguay - Primera Div. - Clausura,S. Ameliano,0,0,0,2,1,0.67,1.33,1,1,0,1,0,0,0,0,1,1,0.5,0.5,1,1,0,0,0,0,0,0,1,0,1.0,3.0,0,0,0,1,0
Paraguay - Primera Div. - Clausura,S. Luqueno,0,0,1,1,1,1.0,0.0,3,0,0,0,0,0,0,1,0,0,2.0,0.0,1,0,0,0,0,0,0,0,1,1,0.5,0.0,2,0,0,0,0
Paraguay - Primera Div. - Clausura,S. Trinidense,2,0,0,0,1,2.67,1.67,1,0,1,1,0,1,0,0,0,0,4.0,3.0,0,0,0,1,0,1,0,0,0,1,2.0,1.0,1,0,1,0,0
Paraguay - Division Intermedia,12 de Junio VH,0,2,6,8,2,1.44,0.78,9,5,3,1,0,0,0,4,4,1,1.33,1.0,4,2,2,1,0,0,2,2,4,1,1.56,0.56,5,3,1,0,0
Paraguay - Division Intermedia,C. River Plate,2,1,3,6,6,1.28,1.28,5,6,4,3,0,2,1,0,3,3,1.56,0.89,4,3,1,1,0,0,0,3,3,3,1.0,1.67,1,3,3,2,0
Paraguay - Division Intermedia,D. Capiata,1,1,4,7,5,1.22,0.61,9,7,2,0,0,0,1,2,4,2,1.22,0.67,5,2,2,0,0,1,0,2,3,3,1.22,0.56,4,5,0,0,0
Paraguay - Division Intermedia,D. Santani,0,2,3,4,9,0.89,1.44,3,9,3,1,2,0,1,2,1,5,0.89,0.89,2,6,1,0,0,0,1,1,3,4,0.89,2.0,1,3,2,1,2
Paraguay - Division Intermedia,Encarnacion,0,2,1,10,5,1.0,1.17,6,7,2,2,1,0,2,0,4,3,1.11,0.56,6,2,0,1,0,0,0,1,6,2,0.89,1.78,0,5,2,1,1
Paraguay - Division Intermedia,F. de la Mora,0,1,3,5,9,0.78,1.22,3,9,5,1,0,0,1,3,3,2,1.33,1.22,1,5,3,0,0,0,0,0,2,7,0.22,1.22,2,4,2,1,0
Paraguay - Division Intermedia,Guairena,0,1,3,5,9,0.78,1.11,5,8,3,2,0,0,1,1,3,4,0.89,0.89,2,6,1,0,0,0,0,2,2,5,0.67,1.33,3,2,2,2,0
Paraguay - Division Intermedia,Guarani de Fram,1,2,2,10,3,1.33,1.61,1,9,4,4,0,1,2,1,3,2,1.67,1.78,0,4,3,2,0,0,0,1,7,1,1.0,1.44,1,5,1,2,0
Paraguay - Division Intermedia,Independiente,0,1,3,9,5,1.0,1.11,7,5,3,3,0,0,1,2,4,2,1.22,0.56,5,3,1,0,0,0,0,1,5,3,0.78,1.67,2,2,2,3,0
Paraguay - Division Intermedia,Pastoreo,0,3,2,6,7,1.06,1.17,4,10,2,1,1,0,2,2,3,2,1.44,1.22,2,5,1,0,1,0,1,0,3,5,0.67,1.11,2,5,1,1,0
Paraguay - Division Intermedia,Resistencia,0,4,3,10,1,1.56,1.56,2,9,3,3,1,0,3,1,5,0,1.78,1.33,2,5,0,1,1,0,1,2,5,1,1.33,1.78,0,4,3,2,0
Paraguay - Division Intermedia,Rubio Nu,3,1,3,7,4,1.56,0.67,9,7,1,1,0,1,1,3,4,0,1.89,0.56,5,3,1,0,0,2,0,0,3,4,1.22,0.78,4,4,0,1,0
Paraguay - Division Intermedia,S. Carapegua,1,0,5,9,3,1.28,0.94,7,7,2,2,0,1,0,3,4,1,1.56,0.56,4,5,0,0,0,0,0,2,5,2,1.0,1.33,3,2,2,2,0
Paraguay - Division Intermedia,San Lorenzo,0,1,3,10,4,1.06,0.94,7,5,6,0,0,0,1,1,4,3,1.0,0.89,4,2,3,0,0,0,0,2,6,1,1.11,1.0,3,3,3,0,0
Paraguay - Division Intermedia,Sol de America,0,0,3,4,11,0.56,1.11,6,6,5,0,1,0,0,2,2,5,0.67,0.78,3,5,1,0,0,0,0,1,2,6,0.44,1.44,3,1,4,0,1
Paraguay - Division Intermedia,Tacuary,0,2,2,8,6,1.0,1.06,6,9,1,0,2,0,1,2,4,2,1.22,1.0,3,5,0,0,1,0,1,0,4,4,0.78,1.11,3,4,1,0,1
Peru - Liga 1 - Apertura,A. Huanuco,0,0,5,6,7,0.89,1.83,4,4,4,3,3,0,0,3,2,4,0.89,1.22,3,2,3,1,0,0,0,2,4,3,0.89,2.44,1,2,1,2,3
Peru - Liga 1 - Apertura,ADT,1,2,4,6,5,1.33,1.67,4,4,7,1,2,1,1,3,2,2,1.67,1.11,3,3,2,1,0,0,1,1,4,3,1.0,2.22,1,1,5,0,2
Peru - Liga 1 - Apertura,Alianza A.,1,2,6,6,3,1.56,1.0,8,5,3,1,1,1,2,3,3,0,2.11,0.78,5,3,0,0,1,0,0,3,3,3,1.0,1.22,3,2,3,1,0
Peru - Liga 1 - Apertura,Alianza Lima,1,1,3,9,4,1.28,0.61,11,5,0,2,0,1,1,2,3,2,1.67,0.33,6,3,0,0,0,0,0,1,6,2,0.89,0.89,5,2,0,2,0
Peru - Liga 1 - Apertura,Atletico Grau,0,3,4,6,5,1.28,1.33,6,4,5,2,1,0,2,2,3,2,1.44,0.89,4,3,1,1,0,0,1,2,3,3,1.11,1.78,2,1,4,1,1
Peru - Liga 1 - Apertura,Ayacucho,0,1,1,9,7,0.78,1.5,4,5,6,2,1,0,1,1,4,3,1.0,1.78,1,3,3,1,1,0,0,0,5,4,0.56,1.22,3,2,3,1,0
Peru - Liga 1 - Apertura,Binacional,1,0,1,14,2,1.11,1.83,4,6,2,3,3,0,0,1,8,0,1.11,1.22,2,4,2,1,0,1,0,0,6,2,1.11,2.44,2,2,0,2,3
Peru - Liga 1 - Apertura,Cajamarca,1,0,4,5,8,0.94,1.89,4,7,2,1,4,1,0,2,1,5,1.0,1.11,3,4,1,0,1,0,0,2,4,3,0.89,2.67,1,3,1,1,3
Peru - Liga 1 - Apertura,Cienciano,1,2,6,5,4,1.61,1.39,3,7,6,2,0,1,2,3,2,1,2.22,1.67,0,4,4,1,0,0,0,3,3,3,1.0,1.11,3,3,2,1,0
Peru - Liga 1 - Apertura,Comerciantes U.,0,1,4,6,7,0.94,1.72,2,7,5,2,2,0,1,1,4,3,1.0,1.44,1,5,2,0,1,0,0,3,2,4,0.89,2.0,1,2,3,2,1
Peru - Liga 1 - Apertura,Cusco,3,4,4,2,5,1.89,1.11,5,8,3,2,0,2,3,1,1,2,2.22,0.89,4,3,1,1,0,1,1,3,1,3,1.56,1.33,1,5,2,1,0
Peru - Liga 1 - Apertura,D. Garcilaso,2,2,6,2,6,1.56,1.06,6,7,3,2,0,2,0,3,1,3,1.67,0.89,3,5,0,1,0,0,2,3,1,3,1.44,1.22,3,2,3,1,0
Peru - Liga 1 - Apertura,FBC Melgar,1,2,4,10,1,1.56,1.11,4,10,3,0,1,1,1,2,4,1,1.67,0.78,3,5,1,0,0,0,1,2,6,0,1.44,1.44,1,5,2,0,1
Peru - Liga 1 - Apertura,Juan Pablo II,1,1,5,3,8,1.11,1.56,5,4,5,2,2,1,1,2,3,2,1.56,0.67,5,2,2,0,0,0,0,3,0,6,0.67,2.44,0,2,3,2,2
Peru - Liga 1 - Apertura,Los Chankas,0,3,4,7,4,1.33,1.39,2,10,3,3,0,0,2,2,4,1,1.56,1.33,1,5,2,1,0,0,1,2,3,3,1.11,1.44,1,5,1,2,0
Peru - Liga 1 - Apertura,S. Cristal,2,2,5,6,3,1.72,1.33,4,7,5,1,1,1,2,4,2,0,2.33,1.0,3,3,3,0,0,1,0,1,4,3,1.11,1.67,1,4,2,1,1
Peru - Liga 1 - Apertura,Sport Boys,2,2,3,6,5,1.44,1.56,2,7,7,1,1,1,1,2,3,2,1.56,1.33,1,4,4,0,0,1,1,1,3,3,1.33,1.78,1,3,3,1,1
Peru - Liga 1 - Apertura,Sport Huancayo,1,2,3,7,5,1.28,1.17,6,6,3,3,0,1,1,3,2,2,1.67,1.11,3,3,2,1,0,0,1,0,5,3,0.89,1.22,3,3,1,2,0
Peru - Liga 1 - Apertura,Universitario,4,3,3,4,4,2.11,0.67,9,6,3,0,0,4,2,1,0,2,3.0,0.56,5,3,1,0,0,0,1,2,4,2,1.22,0.78,4,3,2,0,0
Philippines - PFL,DH Cebu,2,4,2,7,3,1.83,1.0,8,4,4,2,0,1,3,0,4,2,1.7,0.6,5,4,1,0,0,1,1,2,3,1,2.0,1.5,3,0,3,2,0
Philippines - PFL,Davao Aguilas,1,3,2,7,5,1.33,0.89,8,6,2,2,0,0,1,1,3,4,0.89,1.22,2,4,2,1,0,1,2,1,4,1,1.78,0.56,6,2,0,1,0
Philippines - PFL,Kaya FC,5,2,5,4,2,2.67,0.83,5,11,2,0,0,3,2,3,1,1,3.0,0.8,3,6,1,0,0,2,0,2,3,1,2.25,0.88,2,5,1,0,0
Philippines - PFL,Loyola,0,2,4,6,6,1.11,2.17,4,2,5,3,4,0,0,3,1,5,0.78,2.22,1,2,3,1,2,0,2,1,5,1,1.44,2.11,3,0,2,2,2
Philippines - PFL,Maharlika,2,1,2,5,8,1.17,2.06,5,4,1,3,5,0,1,0,3,4,0.75,3.0,1,1,1,1,4,2,0,2,2,4,1.5,1.3,4,3,0,2,1
Philippines - PFL,Manila Digger,7,1,1,7,2,3.11,0.56,10,7,0,1,0,3,0,1,3,2,2.22,0.78,4,4,0,1,0,4,1,0,4,0,4.0,0.33,6,3,0,0,0
Philippines - PFL,Mendiola,0,1,3,5,9,0.78,4.72,1,0,2,5,10,0,0,3,0,6,0.67,5.11,0,0,1,2,6,0,1,0,5,3,0.89,4.33,1,0,1,3,4
Philippines - PFL,One Taguig,5,2,3,1,7,2.17,0.72,8,7,3,0,0,3,1,0,0,5,2.11,0.78,4,3,2,0,0,2,1,3,1,2,2.22,0.67,4,4,1,0,0
Philippines - PFL,PFF Development,0,1,4,5,8,0.89,2.72,2,4,5,1,6,0,1,3,3,1,1.5,2.5,0,4,2,1,1,0,0,1,2,7,0.4,2.9,2,0,3,0,5
Philippines - PFL,Stallion,4,2,2,4,6,2.0,1.39,5,6,4,2,1,2,1,0,2,4,1.89,1.78,2,3,1,2,1,2,1,2,2,2,2.11,1.0,3,3,3,0,0
Poland - Ekstraklasa,Arka Gdynia,0,0,0,0,1,0.0,1.0,0,1,0,0,0,0,0,0,0,0,,,0,0,0,0,0,0,0,0,0,1,0.0,1.0,0,1,0,0,0
Poland - Ekstraklasa,Cracovia Krakow,1,0,0,0,0,4.0,1.0,0,1,0,0,0,0,0,0,0,0,,,0,0,0,0,0,1,0,0,0,0,4.0,1.0,0,1,0,0,0
Poland - Ekstraklasa,Gornik Zabrze,0,0,1,0,0,2.0,1.0,0,1,0,0,0,0,0,1,0,0,2.0,1.0,0,1,0,0,0,0,0,0,0,0,,,0,0,0,0,0
Poland - Ekstraklasa,Jagiellonia,0,0,0,0,1,0.0,4.0,0,0,0,0,1,0,0,0,0,1,0.0,4.0,0,0,0,0,1,0,0,0,0,0,,,0,0,0,0,0
Poland - Ekstraklasa,Katowice,0,0,0,0,1,0.0,1.0,0,1,0,0,0,0,0,0,0,1,0.0,1.0,0,1,0,0,0,0,0,0,0,0,,,0,0,0,0,0
Poland - Ekstraklasa,Korona Kielce,0,0,0,0,1,0.0,2.0,0,0,1,0,0,0,0,0,0,0,,,0,0,0,0,0,0,0,0,0,1,0.0,2.0,0,0,1,0,0
Poland - Ekstraklasa,Lech Poznan,0,0,0,1,0,1.0,4.0,0,0,0,0,1,0,0,0,1,0,1.0,4.0,0,0,0,0,1,0,0,0,0,0,,,0,0,0,0,0
Poland - Ekstraklasa,Lechia Gdansk,0,0,0,1,0,1.0,2.0,0,0,1,0,0,0,0,0,0,0,,,0,0,0,0,0,0,0,0,1,0,1.0,2.0,0,0,1,0,0
Poland - Ekstraklasa,Legia Warsaw,0,0,0,0,0,,,0,0,0,0,0,0,0,0,0,0,,,0,0,0,0,0,0,0,0,0,0,,,0,0,0,0,0
Poland - Ekstraklasa,Motor Lublin,0,0,0,1,0,1.0,0.0,1,0,0,0,0,0,0,0,1,0,1.0,0.0,1,0,0,0,0,0,0,0,0,0,,,0,0,0,0,0
Poland - Ekstraklasa,Piast Gliwice,0,0,0,0,0,,,0,0,0,0,0,0,0,0,0,0,,,0,0,0,0,0,0,0,0,0,0,,,0,0,0,0,0
Poland - Ekstraklasa,Pogon Szczecin,0,0,0,1,0,1.0,5.0,0,0,0,0,1,0,0,0,0,0,,,0,0,0,0,0,0,0,0,1,0,1.0,5.0,0,0,0,0,1
Poland - Ekstraklasa,Radomiak Radom,1,0,0,0,0,5.0,1.0,0,1,0,0,0,1,0,0,0,0,5.0,1.0,0,1,0,0,0,0,0,0,0,0,,,0,0,0,0,0
Poland - Ekstraklasa,Rakow C.,0,0,0,1,0,1.0,0.0,1,0,0,0,0,0,0,0,0,0,,,0,0,0,0,0,0,0,0,1,0,1.0,0.0,1,0,0,0,0
Poland - Ekstraklasa,T. Nieciecza,1,0,0,0,0,4.0,0.0,1,0,0,0,0,0,0,0,0,0,,,0,0,0,0,0,1,0,0,0,0,4.0,0.0,1,0,0,0,0
Poland - Ekstraklasa,Widzew Lodz,0,0,0,1,0,1.0,0.0,1,0,0,0,0,0,0,0,1,0,1.0,0.0,1,0,0,0,0,0,0,0,0,0,,,0,0,0,0,0
Poland - Ekstraklasa,Wisla Plock,0,0,1,0,0,2.0,0.0,1,0,0,0,0,0,0,1,0,0,2.0,0.0,1,0,0,0,0,0,0,0,0,0,,,0,0,0,0,0
Poland - Ekstraklasa,Zaglebie Lubin,0,0,0,0,1,0.0,1.0,0,1,0,0,0,0,0,0,0,0,,,0,0,0,0,0,0,0,0,0,1,0.0,1.0,0,1,0,0,0
Poland - 1. Liga,Chrobry Glogow,0,1,0,0,0,3.0,0.0,1,0,0,0,0,0,1,0,0,0,3.0,0.0,1,0,0,0,0,0,0,0,0,0,,,0,0,0,0,0
Poland - 1. Liga,Gornik Leczna,0,0,0,0,1,0.0,3.0,0,0,0,1,0,0,0,0,0,1,0.0,3.0,0,0,0,1,0,0,0,0,0,0,,,0,0,0,0,0
Poland - 1. Liga,LKS Lodz,0,0,0,1,0,1.0,0.0,1,0,0,0,0,0,0,0,1,0,1.0,0.0,1,0,0,0,0,0,0,0,0,0,,,0,0,0,0,0
Poland - 1. Liga,Miedz Legnica,0,1,0,0,0,3.0,4.0,0,0,0,0,1,0,0,0,0,0,,,0,0,0,0,0,0,1,0,0,0,3.0,4.0,0,0,0,0,1
Poland - 1. Liga,Odra Opole,0,0,0,0,1,0.0,3.0,0,0,0,1,0,0,0,0,0,0,,,0,0,0,0,0,0,0,0,0,1,0.0,3.0,0,0,0,1,0
Poland - 1. Liga,Pogon Grodzisk,0,0,1,0,0,2.0,1.0,0,1,0,0,0,0,0,1,0,0,2.0,1.0,0,1,0,0,0,0,0,0,0,0,,,0,0,0,0,0
Poland - 1. Liga,Pogon Siedlce,0,0,0,1,0,1.0,1.0,0,1,0,0,0,0,0,0,1,0,1.0,1.0,0,1,0,0,0,0,0,0,0,0,,,0,0,0,0,0
Poland - 1. Liga,Polonia Bytom,0,1,0,0,0,3.0,0.0,1,0,0,0,0,0,0,0,0,0,,,0,0,0,0,0,0,1,0,0,0,3.0,0.0,1,0,0,0,0
Poland - 1. Liga,Polonia Warszaw,0,0,0,1,0,1.0,1.0,0,1,0,0,0,0,0,0,0,0,,,0,0,0,0,0,0,0,0,1,0,1.0,1.0,0,1,0,0,0
Poland - 1. Liga,Puszcza Niepolo,0,0,0,1,0,1.0,1.0,0,1,0,0,0,0,0,0,1,0,1.0,1.0,0,1,0,0,0,0,0,0,0,0,,,0,0,0,0,0
Poland - 1. Liga,Ruch Chorzow,0,0,0,1,0,1.0,1.0,0,1,0,0,0,0,0,0,0,0,,,0,0,0,0,0,0,0,0,1,0,1.0,1.0,0,1,0,0,0
Poland - 1. Liga,Slask Wroclaw,0,0,0,1,0,1.0,1.0,0,1,0,0,0,0,0,0,1,0,1.0,1.0,0,1,0,0,0,0,0,0,0,0,,,0,0,0,0,0
Poland - 1. Liga,Stal Mielec,0,0,0,0,1,0.0,4.0,0,0,0,0,1,0,0,0,0,1,0.0,4.0,0,0,0,0,1,0,0,0,0,0,,,0,0,0,0,0
Poland - 1. Liga,Stal Rzeszow,0,0,0,1,0,1.0,2.0,0,0,1,0,0,0,0,0,0,0,,,0,0,0,0,0,0,0,0,1,0,1.0,2.0,0,0,1,0,0
Poland - 1. Liga,Tychy,1,0,0,0,0,4.0,3.0,0,0,0,1,0,1,0,0,0,0,4.0,3.0,0,0,0,1,0,0,0,0,0,0,,,0,0,0,0,0
Poland - 1. Liga,Wieczysta K.,0,0,0,1,0,1.0,1.0,0,1,0,0,0,0,0,0,0,0,,,0,0,0,0,0,0,0,0,1,0,1.0,1.0,0,1,0,0,0
Poland - 1. Liga,Wisla Krakow,1,0,0,0,0,4.0,0.0,1,0,0,0,0,0,0,0,0,0,,,0,0,0,0,0,1,0,0,0,0,4.0,0.0,1,0,0,0,0
Poland - 1. Liga,Znicz Pruszkow,0,0,0,0,1,0.0,1.0,0,1,0,0,0,0,0,0,0,0,,,0,0,0,0,0,0,0,0,0,1,0.0,1.0,0,1,0,0,0
Portugal - Liga Portugal,AVS,0,0,3,19,12,0.74,1.76,8,10,6,5,5,0,0,2,9,6,0.76,1.53,4,6,3,3,1,0,0,1,10,6,0.71,2.0,4,4,3,2,4
Portugal - Liga Portugal,Arouca,1,1,5,18,9,1.03,1.44,8,10,11,3,2,1,0,1,10,5,0.94,1.12,5,6,5,1,0,0,1,4,8,4,1.12,1.76,3,4,6,2,2
Portugal - Liga Portugal,Benfica,7,11,5,9,2,2.47,0.82,15,11,7,1,0,6,6,1,4,0,3.06,0.71,9,4,4,0,0,1,5,4,5,2,1.88,0.94,6,7,3,1,0
Portugal - Liga Portugal,Boavista,0,0,7,10,17,0.71,1.74,7,9,8,7,3,0,0,1,6,10,0.47,1.82,3,4,5,4,1,0,0,6,4,7,0.94,1.65,4,5,3,3,2
Portugal - Liga Portugal,Casa Pia,0,4,6,15,9,1.15,1.29,7,15,7,5,0,0,3,2,9,3,1.29,1.12,3,11,1,2,0,0,1,4,6,6,1.0,1.47,4,4,6,3,0
Portugal - Liga Portugal,Estoril,3,3,10,7,11,1.41,1.56,7,9,12,4,2,2,0,5,5,5,1.35,1.35,5,4,6,1,1,1,3,5,2,6,1.47,1.76,2,5,6,3,1
Portugal - Liga Portugal,Estrela Amadora,0,0,8,8,18,0.71,1.47,7,15,5,4,3,0,0,8,2,7,1.06,1.41,4,7,2,3,1,0,0,0,6,11,0.35,1.53,3,8,3,1,2
Portugal - Liga Portugal,FC Porto,4,5,12,9,4,1.91,0.88,16,11,4,1,2,3,3,7,4,0,2.29,0.65,9,7,0,0,1,1,2,5,5,4,1.53,1.12,7,4,4,1,1
Portugal - Liga Portugal,Famalicao,1,4,6,16,7,1.29,1.15,13,8,9,3,1,1,1,3,7,5,1.18,0.71,9,5,2,1,0,0,3,3,9,2,1.41,1.59,4,3,7,2,1
Portugal - Liga Portugal,Farense,0,0,7,11,16,0.74,1.35,7,13,11,2,1,0,0,2,6,9,0.59,1.41,3,7,6,0,1,0,0,5,5,7,0.88,1.29,4,6,5,2,0
Portugal - Liga Portugal,Gil Vicente,1,4,2,14,13,1.0,1.38,7,15,7,3,2,1,2,1,6,7,1.06,1.12,4,8,4,1,0,0,2,1,8,6,0.94,1.65,3,7,3,2,2
Portugal - Liga Portugal,Guimaraes,2,1,14,8,9,1.38,1.09,13,9,9,2,1,2,1,7,4,3,1.71,1.12,9,1,4,2,1,0,0,7,4,6,1.06,1.06,4,8,5,0,0
Portugal - Liga Portugal,Moreirense,0,4,8,14,8,1.24,1.47,7,11,9,7,0,0,3,3,7,4,1.29,1.24,4,6,6,1,0,0,1,5,7,4,1.18,1.71,3,5,3,6,0
Portugal - Liga Portugal,Nacional,0,3,7,9,15,0.94,1.47,8,11,9,5,1,0,3,5,4,5,1.35,1.59,5,4,4,3,1,0,0,2,5,10,0.53,1.35,3,7,5,2,0
Portugal - Liga Portugal,Rio Ave,0,2,11,11,10,1.15,1.62,5,13,9,5,2,0,1,8,6,2,1.47,1.41,3,6,6,2,0,0,1,3,5,8,0.82,1.82,2,7,3,3,2
Portugal - Liga Portugal,Santa Clara,1,0,10,12,11,1.06,0.94,11,17,4,1,1,0,0,6,6,5,1.06,0.82,7,7,2,1,0,1,0,4,6,6,1.06,1.06,4,10,2,0,1
Portugal - Liga Portugal,Sporting Braga,2,4,10,15,3,1.62,0.88,15,11,6,1,1,2,3,5,6,1,1.94,1.12,6,6,3,1,1,0,1,5,9,2,1.29,0.65,9,5,3,0,0
Portugal - Liga Portugal,Sporting CP,6,13,7,6,2,2.59,0.79,15,13,5,0,1,1,7,6,2,1,2.35,0.76,6,9,2,0,0,5,6,1,4,1,2.82,0.82,9,4,3,0,1
Portugal - Liga Portugal 2,Academico Viseu,1,2,11,11,9,1.26,1.21,8,17,5,2,2,0,1,7,4,5,1.24,0.88,5,9,3,0,0,1,1,4,7,4,1.29,1.53,3,8,2,2,2
Portugal - Liga Portugal 2,Alverca,4,2,11,13,4,1.71,1.0,10,17,5,1,1,3,1,6,5,2,1.94,0.94,7,6,3,0,1,1,1,5,8,2,1.47,1.06,3,11,2,1,0
Portugal - Liga Portugal 2,Benfica B,3,4,8,12,7,1.56,1.12,12,12,6,3,1,2,0,5,6,4,1.47,0.94,9,4,2,1,1,1,4,3,6,3,1.65,1.29,3,8,4,2,0
Portugal - Liga Portugal 2,Chaves,1,2,10,10,11,1.18,1.0,12,12,8,2,0,1,1,6,3,6,1.29,1.06,6,5,5,1,0,0,1,4,7,5,1.06,0.94,6,7,3,1,0
Portugal - Liga Portugal 2,FC Porto B,1,3,5,13,12,1.06,1.38,6,12,14,1,1,0,2,3,7,5,1.12,1.41,2,8,6,0,1,1,1,2,6,7,1.0,1.35,4,4,8,1,0
Portugal - Liga Portugal 2,Feirense,0,3,8,10,13,1.03,1.0,11,16,5,1,1,0,3,5,5,4,1.41,0.94,5,9,2,1,0,0,0,3,5,9,0.65,1.06,6,7,3,0,1
Portugal - Liga Portugal 2,Felgueiras,1,3,8,14,8,1.26,1.12,11,12,7,4,0,1,1,3,9,3,1.29,1.0,7,5,3,2,0,0,2,5,5,5,1.24,1.24,4,7,4,2,0
Portugal - Liga Portugal 2,Leixoes,0,4,7,11,12,1.09,1.24,9,15,5,3,2,0,4,5,4,4,1.53,1.0,4,10,2,1,0,0,0,2,7,8,0.65,1.47,5,5,3,2,2
Portugal - Liga Portugal 2,Mafra,1,1,5,12,15,0.85,1.59,9,7,11,4,3,1,0,5,4,7,1.06,1.29,7,3,4,1,2,0,1,0,8,8,0.65,1.88,2,4,7,3,1
Portugal - Liga Portugal 2,Maritimo,0,2,9,18,5,1.24,1.41,8,12,10,2,2,0,0,4,11,2,1.12,1.29,4,5,7,1,0,0,2,5,7,3,1.35,1.53,4,7,3,1,2
Portugal - Liga Portugal 2,Oliveirense,0,3,5,11,15,0.88,1.88,7,6,11,5,5,0,1,2,6,8,0.76,1.59,4,4,5,3,1,0,2,3,5,7,1.0,2.18,3,2,6,2,4
Portugal - Liga Portugal 2,Pacos Ferreira,1,1,7,13,12,1.0,1.47,8,9,10,7,0,1,0,4,7,5,1.12,1.65,3,5,4,5,0,0,1,3,6,7,0.88,1.29,5,4,6,2,0
Portugal - Liga Portugal 2,Penafiel,1,4,9,11,9,1.32,1.38,6,15,8,4,1,1,3,2,7,4,1.41,1.24,3,8,5,1,0,0,1,7,4,5,1.24,1.53,3,7,3,3,1
Portugal - Liga Portugal 2,Portimonense,1,1,10,10,12,1.12,1.59,7,7,13,7,0,1,1,5,6,4,1.41,1.59,3,4,7,3,0,0,0,5,4,8,0.82,1.59,4,3,6,4,0
Portugal - Liga Portugal 2,Tondela,2,2,17,10,3,1.71,1.03,10,15,8,0,1,1,0,10,4,2,1.65,1.06,5,8,3,0,1,1,2,7,6,1,1.76,1.0,5,7,5,0,0
Portugal - Liga Portugal 2,Torreense,0,6,10,11,7,1.44,1.24,8,14,10,0,2,0,4,4,6,3,1.53,1.35,5,5,5,0,2,0,2,6,5,4,1.35,1.12,3,9,5,0,0
Portugal - Liga Portugal 2,Uniao de Leiria,3,3,4,18,6,1.44,1.09,11,12,8,3,0,1,1,0,11,4,1.12,1.12,6,6,2,3,0,2,2,4,7,2,1.76,1.06,5,6,6,0,0
Portugal - Liga Portugal 2,Vizela,3,3,6,16,6,1.47,0.88,13,14,6,0,1,1,3,2,8,3,1.53,0.88,6,7,4,0,0,2,0,4,8,3,1.41,0.88,7,7,2,0,1
Qatar - Stars League,Al Ahli Doha,2,3,7,5,5,1.73,1.77,5,5,6,3,3,1,1,3,3,3,1.64,1.45,2,5,1,3,0,1,2,4,2,2,1.82,2.09,3,0,5,0,3
Qatar - Stars League,Al Arabi,3,3,2,7,7,1.45,2.23,3,6,3,6,4,2,1,1,5,2,1.64,1.91,1,5,1,3,1,1,2,1,2,5,1.27,2.55,2,1,2,3,3
Qatar - Stars League,Al Duhail,7,0,5,7,3,2.32,0.91,10,6,5,0,1,4,0,2,4,1,2.27,1.09,4,4,2,0,1,3,0,3,3,2,2.36,0.73,6,2,3,0,0
Qatar - Stars League,Al Gharafa,2,6,5,5,4,1.86,1.36,3,12,5,0,2,1,4,2,2,2,2.0,1.45,1,6,3,0,1,1,2,3,3,2,1.73,1.27,2,6,2,0,1
Qatar - Stars League,Al Khor,0,2,2,11,7,0.95,1.91,5,4,6,4,3,0,2,1,4,4,1.09,1.82,3,2,3,1,2,0,0,1,7,3,0.82,2.0,2,2,3,3,1
Qatar - Stars League,Al Rayyan,5,1,6,6,4,2.05,1.59,3,6,11,1,1,2,1,4,2,2,2.0,1.36,2,3,6,0,0,3,0,2,4,2,2.09,1.82,1,3,5,1,1
Qatar - Stars League,Al Sadd,8,4,4,5,1,2.82,1.05,10,5,5,1,1,4,2,2,2,1,2.73,0.82,6,2,2,1,0,4,2,2,3,0,2.91,1.27,4,3,3,0,1
Qatar - Stars League,Al Shahaniya,0,2,10,5,5,1.41,1.95,4,7,3,3,5,0,1,6,1,3,1.45,1.73,2,5,1,1,2,0,1,4,4,2,1.36,2.18,2,2,2,2,3
Qatar - Stars League,Al Shamal,3,3,7,5,4,1.86,1.55,6,8,4,1,3,2,2,4,2,1,2.27,1.91,4,2,2,0,3,1,1,3,3,3,1.45,1.18,2,6,2,1,0
Qatar - Stars League,Al Wakrah,1,4,2,7,8,1.23,1.82,4,7,4,5,2,1,2,1,2,5,1.27,1.91,1,4,2,3,1,0,2,1,5,3,1.18,1.73,3,3,2,2,1
Qatar - Stars League,Qatar SC,0,1,6,11,4,1.18,2.0,4,7,4,2,5,0,0,3,5,3,1.0,2.27,1,4,2,2,2,0,1,3,6,1,1.36,1.73,3,3,2,0,3
Qatar - Stars League,Umm Salal,1,3,5,4,9,1.23,1.95,4,5,5,6,2,1,1,3,1,5,1.27,1.82,2,3,4,1,1,0,2,2,3,4,1.18,2.09,2,2,1,5,1
Romania - Liga 1,Arges,0,0,0,1,1,0.5,2.5,0,0,1,1,0,0,0,0,0,1,0.0,2.0,0,0,1,0,0,0,0,0,1,0,1.0,3.0,0,0,0,1,0
Romania - Liga 1,Botosani,0,0,0,1,1,0.5,0.5,1,1,0,0,0,0,0,0,1,0,1.0,1.0,0,1,0,0,0,0,0,0,0,1,0.0,0.0,1,0,0,0,0
Romania - Liga 1,CFR Cluj,0,0,1,1,0,1.5,1.0,0,2,0,0,0,0,0,1,0,0,2.0,1.0,0,1,0,0,0,0,0,0,1,0,1.0,1.0,0,1,0,0,0
Romania - Liga 1,Csikszereda,0,0,1,1,0,1.5,4.0,0,0,1,0,1,0,0,1,0,0,2.0,2.0,0,0,1,0,0,0,0,0,1,0,1.0,6.0,0,0,0,0,1
Romania - Liga 1,Din. Bucharest,0,0,1,0,1,1.0,1.0,1,0,1,0,0,0,0,0,0,1,0.0,0.0,1,0,0,0,0,0,0,1,0,0,2.0,2.0,0,0,1,0,0
Romania - Liga 1,FCSB,0,0,0,2,0,1.0,0.5,1,1,0,0,0,0,0,0,1,0,1.0,1.0,0,1,0,0,0,0,0,0,1,0,1.0,0.0,1,0,0,0,0
Romania - Liga 1,Farul Constanta,0,1,0,1,0,2.0,1.5,0,1,1,0,0,0,1,0,0,0,3.0,2.0,0,0,1,0,0,0,0,0,1,0,1.0,1.0,0,1,0,0,0
Romania - Liga 1,Hermannstadt,0,0,1,1,0,1.5,1.5,0,1,1,0,0,0,0,1,0,0,2.0,2.0,0,0,1,0,0,0,0,0,1,0,1.0,1.0,0,1,0,0,0
Romania - Liga 1,Metaloglobus,0,0,1,1,0,1.5,3.0,0,0,1,0,1,0,0,0,1,0,1.0,4.0,0,0,0,0,1,0,0,1,0,0,2.0,2.0,0,0,1,0,0
Romania - Liga 1,Otelul,0,0,1,0,1,1.0,1.5,1,0,0,1,0,0,0,0,0,1,0.0,0.0,1,0,0,0,0,0,0,1,0,0,2.0,3.0,0,0,0,1,0
Romania - Liga 1,Petrolul,0,0,0,0,2,0.0,0.5,1,1,0,0,0,0,0,0,0,1,0.0,1.0,0,1,0,0,0,0,0,0,0,1,0.0,0.0,1,0,0,0,0
Romania - Liga 1,Rapid Bucharest,0,0,1,1,0,1.5,0.5,1,1,0,0,0,0,0,0,1,0,1.0,1.0,0,1,0,0,0,0,0,1,0,0,2.0,0.0,1,0,0,0,0
Romania - Liga 1,U. Cluj,1,0,0,1,0,2.5,1.0,0,2,0,0,0,0,0,0,1,0,1.0,1.0,0,1,0,0,0,1,0,0,0,0,4.0,1.0,0,1,0,0,0
Romania - Liga 1,UTA Arad,0,1,0,1,0,2.0,2.0,0,1,0,1,0,0,1,0,0,0,3.0,3.0,0,0,0,1,0,0,0,0,1,0,1.0,1.0,0,1,0,0,0
Romania - Liga 1,Unirea Slobozia,1,0,0,1,0,3.5,1.5,0,1,1,0,0,1,0,0,0,0,6.0,1.0,0,1,0,0,0,0,0,0,1,0,1.0,2.0,0,0,1,0,0
Romania - Liga 1,Univ. Craiova,0,2,0,0,0,3.0,2.0,0,1,0,1,0,0,1,0,0,0,3.0,1.0,0,1,0,0,0,0,1,0,0,0,3.0,3.0,0,0,0,1,0
Scotland - Premiership,Aberdeen,2,3,9,13,11,1.26,1.61,8,13,9,4,4,2,2,5,7,3,1.63,1.37,5,7,4,2,1,0,1,4,6,8,0.89,1.84,3,6,5,2,3
Scotland - Premiership,Celtic,13,10,8,4,3,2.95,0.68,21,11,3,3,0,7,6,5,1,0,3.26,0.47,13,4,1,1,0,6,4,3,3,3,2.63,0.89,8,7,2,2,0
Scotland - Premiership,Dundee FC,3,5,8,14,8,1.5,2.03,4,10,14,5,5,2,4,3,8,2,1.79,2.05,1,6,7,3,2,1,1,5,6,6,1.21,2.0,3,4,7,2,3
Scotland - Premiership,Dundee Utd,0,4,8,17,9,1.18,1.42,12,11,6,6,3,0,2,5,7,5,1.21,1.42,7,4,4,2,2,0,2,3,10,4,1.16,1.42,5,7,2,4,1
Scotland - Premiership,Hearts,2,4,8,14,10,1.37,1.24,11,14,7,5,1,1,3,4,7,4,1.47,1.11,6,8,3,1,1,1,1,4,7,6,1.26,1.37,5,6,4,4,0
Scotland - Premiership,Hibernian,1,9,10,11,7,1.63,1.32,9,16,6,6,1,1,6,6,5,1,2.05,1.21,5,7,5,2,0,0,3,4,6,6,1.21,1.42,4,9,1,4,1
Scotland - Premiership,Kilmarnock,1,4,9,11,13,1.18,1.68,9,13,6,5,5,1,3,4,6,5,1.42,1.05,8,6,2,2,1,0,1,5,5,8,0.95,2.32,1,7,4,3,4
Scotland - Premiership,Motherwell,1,3,11,11,12,1.21,1.66,6,14,8,7,3,1,3,6,2,6,1.5,1.5,4,6,3,5,0,0,0,5,9,6,0.95,1.8,2,8,5,2,3
Scotland - Premiership,Rangers,6,9,7,11,5,2.11,1.08,14,10,11,3,0,4,4,3,6,2,2.32,0.63,10,6,3,0,0,2,5,4,5,3,1.89,1.53,4,4,8,3,0
Scotland - Premiership,Ross County,0,4,6,13,15,0.97,1.71,8,13,6,7,4,0,2,4,8,5,1.16,1.47,3,9,3,3,1,0,2,2,5,10,0.79,1.95,5,4,3,4,3
Scotland - Premiership,St. Johnstone,0,3,5,19,11,1.0,1.79,7,8,13,8,2,0,1,3,10,5,1.0,1.58,5,4,7,2,1,0,2,2,9,6,1.0,2.0,2,4,6,6,1
Scotland - Premiership,St. Mirren,1,5,13,7,12,1.39,1.55,7,12,13,4,2,1,3,7,2,7,1.5,1.35,4,9,5,1,1,0,2,6,5,5,1.28,1.78,3,3,8,3,1
Scotland - Championship,Airdrieonians,1,2,7,9,17,0.94,1.72,5,11,13,4,3,0,2,4,3,9,0.94,1.56,3,7,4,3,1,1,0,3,6,8,0.94,1.89,2,4,9,1,2
Scotland - Championship,Ayr Utd,3,5,7,14,7,1.58,1.08,13,10,12,0,1,3,4,3,7,1,2.17,0.94,7,5,6,0,0,0,1,4,7,6,1.0,1.22,6,5,6,0,1
Scotland - Championship,Dunfermline,1,4,2,8,21,0.78,1.19,10,12,11,3,0,0,4,2,4,8,1.11,0.89,8,5,4,1,0,1,0,0,4,13,0.44,1.5,2,7,7,2,0
Scotland - Championship,Falkirk,4,6,13,8,5,2.0,0.92,17,10,6,2,1,3,2,7,4,2,2.22,0.72,10,4,3,1,0,1,4,6,4,3,1.78,1.11,7,6,3,1,1
Scotland - Championship,Greenock Morton,0,2,15,6,13,1.17,1.33,12,11,7,4,2,0,1,10,2,5,1.39,1.0,7,6,3,2,0,0,1,5,4,8,0.94,1.67,5,5,4,2,2
Scotland - Championship,Hamilton,1,3,7,11,14,1.06,1.78,8,6,10,11,1,0,2,3,6,7,1.0,1.67,5,1,7,5,0,1,1,4,5,7,1.11,1.89,3,5,3,6,1
Scotland - Championship,Livingston,1,8,9,8,10,1.53,0.75,16,15,3,2,0,1,4,5,4,4,1.72,0.5,10,7,1,0,0,0,4,4,4,6,1.33,1.0,6,8,2,2,0
Scotland - Championship,Partick Thistle,1,1,9,17,8,1.19,1.06,14,12,7,1,2,1,1,5,8,3,1.44,0.89,7,8,2,0,1,0,0,4,9,5,0.94,1.22,7,4,5,1,1
Scotland - Championship,Queens Park,1,0,8,16,11,1.0,1.53,10,9,10,4,3,0,0,4,8,6,0.89,1.72,4,6,4,1,3,1,0,4,8,5,1.11,1.33,6,3,6,3,0
Scotland - Championship,Raith Rovers,1,6,7,10,12,1.31,1.19,13,11,5,6,1,0,2,6,7,3,1.39,0.94,9,5,1,2,1,1,4,1,3,9,1.22,1.44,4,6,4,4,0
Serbia - Super Liga,Backa Topola,0,0,1,0,0,2.0,1.0,0,1,0,0,0,0,0,1,0,0,2.0,1.0,0,1,0,0,0,0,0,0,0,0,,,0,0,0,0,0
Serbia - Super Liga,Cukaricki,0,0,0,1,0,1.0,0.0,1,0,0,0,0,0,0,0,1,0,1.0,0.0,1,0,0,0,0,0,0,0,0,0,,,0,0,0,0,0
Serbia - Super Liga,IMT N. Beograd,0,0,0,1,0,1.0,1.0,0,1,0,0,0,0,0,0,0,0,,,0,0,0,0,0,0,0,0,1,0,1.0,1.0,0,1,0,0,0
Serbia - Super Liga,Javor Ivanjica,0,0,0,0,1,0.0,4.0,0,0,0,0,1,0,0,0,0,0,,,0,0,0,0,0,0,0,0,0,1,0.0,4.0,0,0,0,0,1
Serbia - Super Liga,Mladost Lucani,0,0,0,1,0,1.0,1.0,0,1,0,0,0,0,0,0,1,0,1.0,1.0,0,1,0,0,0,0,0,0,0,0,,,0,0,0,0,0
Serbia - Super Liga,Napredak,0,0,0,0,1,0.0,1.0,0,1,0,0,0,0,0,0,0,0,,,0,0,0,0,0,0,0,0,0,1,0.0,1.0,0,1,0,0,0
Serbia - Super Liga,Novi Pazar,0,0,0,0,0,,,0,0,0,0,0,0,0,0,0,0,,,0,0,0,0,0,0,0,0,0,0,,,0,0,0,0,0
Serbia - Super Liga,OFK Beograd,0,0,0,1,0,1.0,3.0,0,0,0,1,0,0,0,0,1,0,1.0,3.0,0,0,0,1,0,0,0,0,0,0,,,0,0,0,0,0
Serbia - Super Liga,Partizan,0,0,0,1,0,1.0,0.0,1,0,0,0,0,0,0,0,0,0,,,0,0,0,0,0,0,0,0,1,0,1.0,0.0,1,0,0,0,0
Serbia - Super Liga,R. Surdulica,0,0,0,0,1,0.0,2.0,0,0,1,0,0,0,0,0,0,0,,,0,0,0,0,0,0,0,0,0,1,0.0,2.0,0,0,1,0,0
Serbia - Super Liga,Radnicki 1923,0,0,0,0,0,,,0,0,0,0,0,0,0,0,0,0,,,0,0,0,0,0,0,0,0,0,0,,,0,0,0,0,0
Serbia - Super Liga,Radnicki Nis,0,0,0,1,0,1.0,2.0,0,0,1,0,0,0,0,0,0,0,,,0,0,0,0,0,0,0,0,1,0,1.0,2.0,0,0,1,0,0
Serbia - Super Liga,Red Star,1,0,0,0,0,4.0,0.0,1,0,0,0,0,1,0,0,0,0,4.0,0.0,1,0,0,0,0,0,0,0,0,0,,,0,0,0,0,0
Serbia - Super Liga,S. Subotica,0,1,0,0,0,3.0,1.0,0,1,0,0,0,0,0,0,0,0,,,0,0,0,0,0,0,1,0,0,0,3.0,1.0,0,1,0,0,0
Serbia - Super Liga,Vojvodina,0,0,1,0,0,2.0,0.0,1,0,0,0,0,0,0,1,0,0,2.0,0.0,1,0,0,0,0,0,0,0,0,0,,,0,0,0,0,0
Serbia - Super Liga,Z. Pancevo,0,0,0,0,1,0.0,1.0,0,1,0,0,0,0,0,0,0,1,0.0,1.0,0,1,0,0,0,0,0,0,0,0,,,0,0,0,0,0
Singapore - Premier League,A. Niigata (S),5,3,7,8,9,1.72,2.22,5,10,5,5,7,4,1,4,3,4,2.13,1.94,3,6,2,1,4,1,2,3,5,5,1.31,2.5,2,4,3,4,3
Singapore - Premier League,DPMM FC,3,6,10,4,9,1.69,1.91,3,10,8,9,2,0,3,6,3,4,1.5,1.81,2,5,4,4,1,3,3,4,1,5,1.88,2.0,1,5,4,5,1
Singapore - Premier League,Geylang,12,6,6,6,2,3.03,2.0,5,7,8,7,5,8,1,1,4,2,2.94,2.38,2,4,1,4,5,4,5,5,2,0,3.13,1.63,3,3,7,3,0
Singapore - Premier League,Hougang,4,5,5,17,1,1.91,2.38,4,8,6,6,8,2,3,5,6,0,2.25,2.13,3,4,2,4,3,2,2,0,11,1,1.56,2.63,1,4,4,2,5
Singapore - Premier League,Khalsa,8,7,9,7,1,2.63,2.5,5,2,9,8,8,2,5,7,2,0,2.5,2.75,0,2,6,3,5,6,2,2,5,1,2.75,2.25,5,0,3,5,3
Singapore - Premier League,Lion City,11,6,6,5,4,3.0,1.0,12,13,4,2,1,4,6,2,1,3,2.94,1.13,5,8,1,1,1,7,0,4,4,1,3.06,0.88,7,5,3,1,0
Singapore - Premier League,Tampines Rovers,9,7,10,3,3,2.63,1.16,12,9,7,2,2,2,5,6,1,2,2.38,1.13,6,5,3,1,1,7,2,4,2,1,2.88,1.19,6,4,4,1,1
Singapore - Premier League,Tanjong Pagar,0,5,4,12,11,1.09,3.22,1,7,4,7,13,0,3,2,5,6,1.13,2.69,1,5,3,3,4,0,2,2,7,5,1.06,3.75,0,2,1,4,9
Singapore - Premier League,Young Lions,2,7,4,10,9,1.47,2.78,2,6,10,6,8,2,2,1,5,6,1.31,3.31,0,3,5,2,6,0,5,3,5,3,1.63,2.25,2,3,5,4,2
Slovenia - Prva Liga,Aluminij,0,0,1,0,0,2.0,1.0,0,1,0,0,0,0,0,0,0,0,,,0,0,0,0,0,0,0,1,0,0,2.0,1.0,0,1,0,0,0
Slovenia - Prva Liga,Bravo,0,0,0,1,0,1.0,2.0,0,0,1,0,0,0,0,0,0,0,,,0,0,0,0,0,0,0,0,1,0,1.0,2.0,0,0,1,0,0
Slovenia - Prva Liga,Domzale,0,0,1,0,0,2.0,3.0,0,0,0,1,0,0,0,0,0,0,,,0,0,0,0,0,0,0,1,0,0,2.0,3.0,0,0,0,1,0
Slovenia - Prva Liga,Koper,0,0,1,0,0,2.0,1.0,0,1,0,0,0,0,0,1,0,0,2.0,1.0,0,1,0,0,0,0,0,0,0,0,,,0,0,0,0,0
Slovenia - Prva Liga,Maribor,0,0,0,1,0,1.0,2.0,0,0,1,0,0,0,0,0,1,0,1.0,2.0,0,0,1,0,0,0,0,0,0,0,,,0,0,0,0,0
Slovenia - Prva Liga,Mura,0,0,0,0,1,0.0,1.0,0,1,0,0,0,0,0,0,0,0,,,0,0,0,0,0,0,0,0,0,1,0.0,1.0,0,1,0,0,0
Slovenia - Prva Liga,NK Celje,0,0,1,0,0,2.0,1.0,0,1,0,0,0,0,0,0,0,0,,,0,0,0,0,0,0,0,1,0,0,2.0,1.0,0,1,0,0,0
Slovenia - Prva Liga,NK Olimpija,0,0,0,1,0,1.0,0.0,1,0,0,0,0,0,0,0,1,0,1.0,0.0,1,0,0,0,0,0,0,0,0,0,,,0,0,0,0,0
Slovenia - Prva Liga,Primorje,0,1,0,0,0,3.0,2.0,0,0,1,0,0,0,1,0,0,0,3.0,2.0,0,0,1,0,0,0,0,0,0,0,,,0,0,0,0,0
Slovenia - Prva Liga,Radomlje,0,0,0,1,0,1.0,2.0,0,0,1,0,0,0,0,0,1,0,1.0,2.0,0,0,1,0,0,0,0,0,0,0,,,0,0,0,0,0
Slovakia - Fortuna Liga,DAC Streda,0,0,0,0,0,,,0,0,0,0,0,0,0,0,0,0,,,0,0,0,0,0,0,0,0,0,0,,,0,0,0,0,0
Slovakia - Fortuna Liga,FC Kosice,0,0,0,0,0,,,0,0,0,0,0,0,0,0,0,0,,,0,0,0,0,0,0,0,0,0,0,,,0,0,0,0,0
Slovakia - Fortuna Liga,Komarno,0,0,0,0,0,,,0,0,0,0,0,0,0,0,0,0,,,0,0,0,0,0,0,0,0,0,0,,,0,0,0,0,0
Slovakia - Fortuna Liga,Podbrezova,0,0,0,0,0,,,0,0,0,0,0,0,0,0,0,0,,,0,0,0,0,0,0,0,0,0,0,,,0,0,0,0,0
Slovakia - Fortuna Liga,Presov,0,0,0,0,0,,,0,0,0,0,0,0,0,0,0,0,,,0,0,0,0,0,0,0,0,0,0,,,0,0,0,0,0
Slovakia - Fortuna Liga,Ruzomberok,0,0,0,0,0,,,0,0,0,0,0,0,0,0,0,0,,,0,0,0,0,0,0,0,0,0,0,,,0,0,0,0,0
Slovakia - Fortuna Liga,S. Bratislava,0,0,0,0,0,,,0,0,0,0,0,0,0,0,0,0,,,0,0,0,0,0,0,0,0,0,0,,,0,0,0,0,0
Slovakia - Fortuna Liga,Skalica,0,0,0,0,0,,,0,0,0,0,0,0,0,0,0,0,,,0,0,0,0,0,0,0,0,0,0,,,0,0,0,0,0
Slovakia - Fortuna Liga,Spartak Trnava,0,0,0,0,0,,,0,0,0,0,0,0,0,0,0,0,,,0,0,0,0,0,0,0,0,0,0,,,0,0,0,0,0
Slovakia - Fortuna Liga,Trencin,0,0,0,0,0,,,0,0,0,0,0,0,0,0,0,0,,,0,0,0,0,0,0,0,0,0,0,,,0,0,0,0,0
Slovakia - Fortuna Liga,Z. Michalovce,0,0,0,0,0,,,0,0,0,0,0,0,0,0,0,0,,,0,0,0,0,0,0,0,0,0,0,,,0,0,0,0,0
Slovakia - Fortuna Liga,Zilina,0,0,0,0,0,,,0,0,0,0,0,0,0,0,0,0,,,0,0,0,0,0,0,0,0,0,0,,,0,0,0,0,0
South Africa - Premier Division ,AmaZulu,0,2,6,11,9,1.04,1.21,10,8,7,1,2,0,1,4,5,4,1.14,1.14,6,4,2,1,1,0,1,2,6,5,0.93,1.29,4,4,5,0,1
South Africa - Premier Division ,Cape Town City,0,0,3,9,16,0.54,1.11,10,8,7,3,0,0,0,1,7,6,0.64,0.79,6,5,3,0,0,0,0,2,2,10,0.43,1.43,4,3,4,3,0
South Africa - Premier Division ,Chippa Utd,1,0,7,4,16,0.79,1.0,9,12,5,2,0,0,0,6,1,7,0.93,0.86,6,5,2,1,0,1,0,1,3,9,0.64,1.14,3,7,3,1,0
South Africa - Premier Division ,Golden Arrows,0,2,3,8,15,0.71,1.14,9,10,6,2,1,0,2,2,3,7,0.93,1.07,4,6,3,1,0,0,0,1,5,8,0.5,1.21,5,4,3,1,1
South Africa - Premier Division ,Kaizer Chiefs,0,1,5,12,10,0.89,1.14,7,12,8,0,1,0,0,3,8,3,1.0,1.14,5,4,4,0,1,0,1,2,4,7,0.79,1.14,2,8,4,0,0
South Africa - Premier Division ,Magesi,0,0,3,13,12,0.68,1.11,10,9,6,2,1,0,0,3,8,3,1.0,1.07,5,5,3,0,1,0,0,0,5,9,0.36,1.14,5,4,3,2,0
South Africa - Premier Division ,Mamelodi S.,5,8,8,5,2,2.32,0.46,17,9,2,0,0,4,5,4,1,0,2.86,0.21,11,3,0,0,0,1,3,4,4,2,1.79,0.71,6,6,2,0,0
South Africa - Premier Division ,Marumo G.,0,1,4,15,8,0.93,1.39,7,12,6,1,2,0,1,1,9,3,1.0,0.93,5,6,2,1,0,0,0,3,6,5,0.86,1.86,2,6,4,0,2
South Africa - Premier Division ,Orlando Pirates,1,2,9,11,5,1.54,0.71,12,14,1,0,1,1,2,5,4,2,2.0,0.64,5,9,0,0,0,0,0,4,7,3,1.07,0.79,7,5,1,0,1
South Africa - Premier Division ,Polokwane,0,1,3,10,14,0.68,0.89,10,12,5,1,0,0,1,2,7,4,1.0,0.79,4,9,1,0,0,0,0,1,3,10,0.36,1.0,6,3,4,1,0
South Africa - Premier Division ,Richards Bay,0,0,5,9,14,0.68,0.93,12,9,4,3,0,0,0,4,3,7,0.79,0.64,8,4,1,1,0,0,0,1,6,7,0.57,1.21,4,5,3,2,0
South Africa - Premier Division ,Royal AM,0,0,0,0,0,,,0,0,0,0,0,0,0,0,0,0,,,0,0,0,0,0,0,0,0,0,0,,,0,0,0,0,0
South Africa - Premier Division ,Sekhukhune,1,1,8,16,2,1.39,1.11,10,10,4,3,1,1,0,4,9,0,1.5,1.14,6,3,3,1,1,0,1,4,7,2,1.29,1.07,4,7,1,2,0
South Africa - Premier Division ,Stellenbosch,1,3,4,12,8,1.21,0.75,12,12,3,1,0,0,1,2,7,4,1.0,0.71,5,8,1,0,0,1,2,2,5,4,1.43,0.79,7,4,2,1,0
South Africa - Premier Division ,SuperSport Utd,1,0,1,12,14,0.64,1.07,9,11,5,3,0,0,0,1,5,8,0.5,0.93,6,5,1,2,0,1,0,0,7,6,0.79,1.21,3,6,4,1,0
South Africa - Premier Division ,TS Galaxy,0,2,4,16,6,1.07,1.07,7,15,4,1,1,0,1,3,6,4,1.07,0.79,7,4,2,1,0,0,1,1,10,2,1.07,1.36,0,11,2,0,1
South Korea - K League 1,Anyang,1,2,4,10,6,1.22,1.3,4,9,9,1,0,1,1,3,4,3,1.42,1.25,2,6,3,1,0,0,1,1,6,3,1.0,1.36,2,3,6,0,0
South Korea - K League 1,Daegu,0,2,5,8,8,1.04,1.91,1,8,8,4,2,0,2,2,3,4,1.18,1.55,0,8,1,1,1,0,0,3,5,4,0.92,2.25,1,0,7,3,1
South Korea - K League 1,Daejeon Citizen,0,3,7,7,5,1.36,1.18,6,8,6,2,0,0,0,2,5,4,0.82,1.0,4,4,2,1,0,0,3,5,2,1,1.91,1.36,2,4,4,1,0
South Korea - K League 1,Gangwon,0,2,4,8,8,1.0,1.18,7,8,4,2,1,0,1,2,3,5,0.91,1.36,4,3,1,2,1,0,1,2,5,3,1.09,1.0,3,5,3,0,0
South Korea - K League 1,Gimcheon Sangmu,1,3,5,8,6,1.35,1.0,9,7,5,2,0,0,0,2,6,3,0.91,0.64,6,3,2,0,0,1,3,3,2,3,1.75,1.33,3,4,3,2,0
South Korea - K League 1,Gwangju,0,0,7,10,6,1.04,1.13,6,11,3,3,0,0,0,4,5,3,1.08,1.17,3,6,1,2,0,0,0,3,5,3,1.0,1.09,3,5,2,1,0
South Korea - K League 1,Jeju Utd,0,1,5,10,6,1.05,1.23,7,7,4,4,0,0,0,5,3,3,1.18,1.18,5,2,1,3,0,0,1,0,7,3,0.91,1.27,2,5,3,1,0
South Korea - K League 1,Jeonbuk,1,5,7,6,3,1.77,0.82,8,10,4,0,0,0,3,4,3,1,1.82,1.18,1,7,3,0,0,1,2,3,3,2,1.73,0.45,7,3,1,0,0
South Korea - K League 1,Pohang Steelers,0,2,7,9,5,1.26,1.48,5,9,5,2,2,0,0,5,4,3,1.17,1.42,4,4,1,2,1,0,2,2,5,2,1.36,1.55,1,5,4,0,1
South Korea - K League 1,Seoul,1,2,2,10,7,1.09,0.91,8,9,4,1,0,1,1,2,5,2,1.45,1.27,2,5,3,1,0,0,1,0,5,5,0.73,0.55,6,4,1,0,0
South Korea - K League 1,Suwon City,1,2,3,9,7,1.18,1.32,4,10,5,3,0,0,2,2,5,2,1.36,1.18,2,5,4,0,0,1,0,1,4,5,1.0,1.45,2,5,1,3,0
South Korea - K League 1,Ulsan,0,2,5,9,5,1.19,1.05,7,8,4,2,0,0,2,3,3,2,1.5,1.1,4,2,3,1,0,0,0,2,6,3,0.91,1.0,3,6,1,1,0
South Korea - K League 2,Ansan Greeners,0,1,3,7,10,0.76,1.24,7,6,4,4,0,0,1,1,3,6,0.73,1.36,3,3,3,2,0,0,0,2,4,4,0.8,1.1,4,3,1,2,0
South Korea - K League 2,Asan,0,4,5,6,6,1.33,1.29,6,8,4,2,1,0,2,3,2,3,1.4,1.2,3,4,1,2,0,0,2,2,4,3,1.27,1.36,3,4,3,0,1
South Korea - K League 2,Bucheon FC,1,4,6,7,3,1.71,1.29,6,8,3,3,1,1,3,2,4,1,2.0,1.36,2,5,2,2,0,0,1,4,3,2,1.4,1.2,4,3,1,1,1
South Korea - K League 2,Busan IPark,1,2,6,4,8,1.24,1.1,7,8,4,1,1,0,1,4,1,5,1.09,1.36,3,3,4,0,1,1,1,2,3,3,1.4,0.8,4,5,0,1,0
South Korea - K League 2,Cheonan City,1,1,1,8,10,0.81,1.67,4,4,8,5,0,1,1,1,3,4,1.2,1.7,1,3,4,2,0,0,0,0,5,6,0.45,1.64,3,1,4,3,0
South Korea - K League 2,Cheongju,0,2,5,8,6,1.14,1.76,3,5,8,4,1,0,1,3,1,4,1.11,1.56,1,3,4,1,0,0,1,2,7,2,1.17,1.92,2,2,4,3,1
South Korea - K League 2,Gimpo,0,2,4,9,6,1.1,1.0,9,5,5,2,0,0,2,2,6,2,1.33,1.0,5,3,3,1,0,0,0,2,3,4,0.78,1.0,4,2,2,1,0
South Korea - K League 2,Gyeongnam,0,2,3,6,10,0.86,1.67,2,9,5,4,1,0,2,2,3,4,1.18,1.64,1,5,2,3,0,0,0,1,3,6,0.5,1.7,1,4,3,1,1
South Korea - K League 2,Hwaseong,0,2,4,7,8,1.0,1.38,4,9,4,4,0,0,0,2,5,4,0.82,0.82,3,7,1,0,0,0,2,2,2,4,1.2,2.0,1,2,3,4,0
South Korea - K League 2,Incheon Utd,0,5,9,7,0,1.9,0.62,12,6,2,1,0,0,2,6,3,0,1.91,0.27,8,3,0,0,0,0,3,3,4,0,1.9,1.0,4,3,2,1,0
South Korea - K League 2,Jeonnam,1,2,7,7,4,1.48,1.1,7,7,6,0,1,1,2,2,2,2,1.78,1.22,2,5,1,0,1,0,0,5,5,2,1.25,1.0,5,2,5,0,0
South Korea - K League 2,Seongnam,0,0,3,10,8,0.76,0.81,10,6,4,1,0,0,0,2,4,4,0.8,0.8,5,2,3,0,0,0,0,1,6,4,0.73,0.82,5,4,1,1,0
South Korea - K League 2,Seoul E-Land,1,2,7,8,3,1.52,1.57,2,10,6,1,2,1,2,2,3,2,1.7,1.5,1,5,3,0,1,0,0,5,5,1,1.36,1.64,1,5,3,1,1
South Korea - K League 2,Suwon Bluewings,4,5,4,6,2,2.14,1.29,5,9,4,2,1,2,2,2,4,1,2.0,0.82,4,5,2,0,0,2,3,2,2,1,2.3,1.8,1,4,2,2,1
Spain - La Liga,Alaves,0,2,9,14,13,1.0,1.26,9,16,7,6,0,0,0,3,8,8,0.74,0.89,7,9,1,2,0,0,2,6,6,5,1.26,1.63,2,7,6,4,0
Spain - La Liga,Athletic Bilbao,2,4,8,15,9,1.42,0.76,15,18,4,1,0,2,3,2,8,4,1.68,0.68,8,10,0,1,0,0,1,6,7,5,1.16,0.84,7,8,4,0,0
Spain - La Liga,Atletico Madrid,6,5,7,14,6,1.79,0.79,17,15,4,1,1,4,4,4,6,1,2.21,0.79,10,6,1,1,1,2,1,3,8,5,1.37,0.79,7,9,3,0,0
Spain - La Liga,Celta Vigo,0,7,11,16,4,1.55,1.5,8,12,11,5,2,0,5,5,7,2,1.68,1.11,5,7,7,0,0,0,2,6,9,2,1.42,1.89,3,5,4,5,2
Spain - La Liga,Espanyol,1,2,6,18,11,1.05,1.34,8,17,8,2,3,0,2,4,9,4,1.21,1.05,4,10,5,0,0,1,0,2,9,7,0.89,1.63,4,7,3,2,3
Spain - La Liga,FC Barcelona,13,4,10,9,2,2.68,1.03,13,16,5,3,1,7,2,2,7,1,2.74,1.05,7,7,2,3,0,6,2,8,2,1,2.63,1.0,6,9,3,0,1
Spain - La Liga,Getafe,1,1,7,13,16,0.89,1.03,9,21,6,2,0,0,0,3,9,7,0.79,1.0,6,8,4,1,0,1,1,4,4,9,1.0,1.05,3,13,2,1,0
Spain - La Liga,Girona,3,1,6,17,11,1.16,1.58,8,12,9,6,3,3,1,3,6,6,1.42,1.58,4,7,3,3,2,0,0,3,11,5,0.89,1.58,4,5,6,3,1
Spain - La Liga,Las Palmas,0,3,7,17,11,1.05,1.61,4,15,12,6,1,0,0,6,9,4,1.11,1.53,3,7,5,4,0,0,3,1,8,7,1.0,1.68,1,8,7,2,1
Spain - La Liga,Leganes,0,5,5,14,14,1.03,1.47,11,11,6,8,2,0,4,3,5,7,1.21,1.42,6,6,2,4,1,0,1,2,9,7,0.84,1.53,5,5,4,4,1
Spain - La Liga,Mallorca,0,2,7,15,14,0.92,1.16,9,19,8,0,2,0,1,4,9,5,1.05,1.11,5,10,3,0,1,0,1,3,6,9,0.79,1.21,4,9,5,0,1
Spain - La Liga,Osasuna,1,3,9,17,8,1.26,1.37,9,15,8,3,3,1,2,7,9,0,1.74,1.21,5,6,7,1,0,0,1,2,8,8,0.79,1.53,4,9,1,2,3
Spain - La Liga,Rayo Vallecano,0,2,8,19,9,1.08,1.18,10,17,6,4,1,0,2,4,10,3,1.26,1.37,4,8,4,2,1,0,0,4,9,6,0.89,1.0,6,9,2,2,0
Spain - La Liga,Real Betis,1,3,14,15,5,1.5,1.32,7,18,9,2,2,1,1,7,10,0,1.68,1.11,5,8,5,1,0,0,2,7,5,5,1.32,1.53,2,10,4,1,2
Spain - La Liga,Real Madrid,4,9,12,11,2,2.05,1.0,15,13,7,1,2,4,4,7,3,1,2.37,1.0,8,5,5,0,1,0,5,5,8,1,1.74,1.0,7,8,2,1,1
Spain - La Liga,Real Sociedad,0,5,6,8,19,0.92,1.21,13,10,11,2,2,0,3,3,5,8,1.05,1.05,7,5,6,1,0,0,2,3,3,11,0.79,1.37,6,5,5,1,2
Spain - La Liga,Sevilla FC,1,1,8,19,9,1.11,1.45,10,13,9,1,5,0,0,2,13,4,0.89,1.21,5,7,6,0,1,1,1,6,6,5,1.32,1.68,5,6,3,1,4
Spain - La Liga,Valencia,1,3,7,17,10,1.16,1.42,8,17,6,6,1,1,1,6,7,4,1.37,1.05,7,6,4,2,0,0,2,1,10,6,0.95,1.79,1,11,2,4,1
Spain - La Liga,Valladolid,0,1,2,19,16,0.68,2.37,5,7,12,6,8,0,0,1,9,9,0.58,1.68,5,5,4,2,3,0,1,1,10,7,0.79,3.05,0,2,8,4,5
Spain - La Liga,Villarreal,6,4,11,11,6,1.87,1.34,7,16,12,2,1,5,3,3,7,1,2.26,1.42,5,5,7,1,1,1,1,8,4,5,1.47,1.26,2,11,5,1,0
Spain - La Liga 2,Albacete,1,5,14,10,12,1.36,1.36,10,16,11,3,2,0,5,9,2,5,1.67,1.19,7,7,5,1,1,1,0,5,8,7,1.05,1.52,3,9,6,2,1
Spain - La Liga 2,Almeria,4,2,17,15,4,1.71,1.31,11,18,6,4,3,3,1,10,6,1,2.0,0.9,8,10,2,0,1,1,1,7,9,3,1.43,1.71,3,8,4,4,2
Spain - La Liga 2,Burgos,0,3,8,16,15,0.98,1.14,14,11,14,3,0,0,3,5,7,6,1.24,1.1,6,8,6,1,0,0,0,3,9,9,0.71,1.19,8,3,8,2,0
Spain - La Liga 2,Cadiz,3,3,11,11,14,1.31,1.26,13,13,11,2,3,2,1,6,5,7,1.38,1.0,10,5,4,0,2,1,2,5,6,7,1.24,1.52,3,8,7,2,1
Spain - La Liga 2,Cartagena,0,0,8,17,17,0.79,1.86,7,12,10,8,5,0,0,2,9,10,0.62,1.33,6,7,5,2,1,0,0,6,8,7,0.95,2.38,1,5,5,6,4
Spain - La Liga 2,Castellon,5,2,14,10,11,1.55,1.5,8,15,11,7,1,4,0,8,4,5,1.71,1.33,5,8,4,4,0,1,2,6,6,6,1.38,1.67,3,7,7,3,1
Spain - La Liga 2,Cordoba,2,4,11,16,9,1.4,1.5,9,12,15,3,3,2,2,8,6,3,1.76,1.24,6,5,9,1,0,0,2,3,10,6,1.05,1.76,3,7,6,2,3
Spain - La Liga 2,Deportivo,5,1,5,19,12,1.33,1.29,11,13,15,1,2,2,1,2,9,7,1.24,1.29,6,8,4,1,2,3,0,3,10,5,1.43,1.29,5,5,11,0,0
Spain - La Liga 2,Eibar,1,1,11,15,14,1.05,0.98,14,16,11,1,0,1,0,6,11,3,1.29,0.9,8,8,4,1,0,0,1,5,4,11,0.81,1.05,6,8,7,0,0
Spain - La Liga 2,Elche,2,4,12,15,9,1.4,0.81,19,15,5,3,0,1,3,9,6,2,1.76,0.71,11,6,3,1,0,1,1,3,9,7,1.05,0.9,8,9,2,2,0
Spain - La Liga 2,Eldense,1,1,11,15,14,1.05,1.5,12,11,8,9,2,0,1,7,9,4,1.24,1.48,7,4,4,5,1,1,0,4,6,10,0.86,1.52,5,7,4,4,1
Spain - La Liga 2,Granada,2,9,7,16,8,1.55,1.29,12,11,16,2,1,2,5,3,7,4,1.71,1.0,8,6,6,1,0,0,4,4,9,4,1.38,1.57,4,5,10,1,1
Spain - La Liga 2,Huesca,2,6,7,18,9,1.38,1.17,11,17,11,2,1,2,4,5,9,1,1.86,1.19,4,10,6,1,0,0,2,2,9,8,0.9,1.14,7,7,5,1,1
Spain - La Liga 2,Levante,3,9,9,11,10,1.64,1.0,11,20,11,0,0,3,6,2,7,3,2.0,0.95,6,10,5,0,0,0,3,7,4,7,1.29,1.05,5,10,6,0,0
Spain - La Liga 2,Malaga,0,2,11,14,15,1.0,1.1,16,10,13,2,1,0,1,4,11,5,1.05,0.76,10,7,3,1,0,0,1,7,3,10,0.95,1.43,6,3,10,1,1
Spain - La Liga 2,Mirandes,2,6,10,13,11,1.4,0.95,16,17,5,3,1,1,4,7,6,3,1.71,0.71,10,7,4,0,0,1,2,3,7,8,1.1,1.19,6,10,1,3,1
Spain - La Liga 2,Racing,1,4,17,13,7,1.55,1.21,11,16,10,5,0,1,0,12,6,2,1.71,0.95,7,9,4,1,0,0,4,5,7,5,1.38,1.48,4,7,6,4,0
Spain - La Liga 2,Racing Ferrol,0,1,1,17,23,0.52,1.52,14,10,8,5,5,0,0,1,10,10,0.57,1.38,8,5,4,1,3,0,1,0,7,13,0.48,1.67,6,5,4,4,2
Spain - La Liga 2,Real Oviedo,2,5,7,18,10,1.33,1.0,16,16,5,4,1,1,4,4,10,2,1.62,0.95,9,7,2,3,0,1,1,3,8,8,1.05,1.05,7,9,3,1,1
Spain - La Liga 2,Real Zaragoza,1,4,13,14,10,1.33,1.5,8,16,12,2,4,0,2,7,8,4,1.33,1.29,6,7,5,2,1,1,2,6,6,6,1.33,1.71,2,9,7,0,3
Spain - La Liga 2,Sporting Gijon,0,6,10,19,7,1.36,1.29,9,20,6,6,1,0,3,6,9,3,1.43,1.19,6,8,4,3,0,0,3,4,10,4,1.29,1.38,3,12,2,3,1
Spain - La Liga 2,Tenerife,0,2,9,11,20,0.83,1.31,9,18,9,5,1,0,1,7,4,9,1.0,0.9,8,10,0,3,0,0,1,2,7,11,0.67,1.71,1,8,9,2,1
Sweden - Allsvenskan,AIK,1,3,3,5,5,1.41,0.94,9,3,2,3,0,1,2,2,0,2,2.0,0.57,5,1,0,1,0,0,1,1,5,3,1.0,1.2,4,2,2,2,0
Sweden - Allsvenskan,Brommapojkarna,0,4,3,3,6,1.31,1.38,4,6,3,2,1,0,1,1,1,4,0.86,1.43,1,3,2,1,0,0,3,2,2,2,1.67,1.33,3,3,1,1,1
Sweden - Allsvenskan,Degerfors,2,0,1,7,6,1.13,2.25,2,4,2,5,3,0,0,0,5,3,0.63,2.13,1,2,1,3,1,2,0,1,2,3,1.63,2.38,1,2,1,2,2
Sweden - Allsvenskan,Djurgarden,1,0,1,8,6,0.94,1.06,5,8,1,1,1,1,0,0,6,2,1.22,0.89,3,5,0,1,0,0,0,1,2,4,0.57,1.29,2,3,1,0,1
Sweden - Allsvenskan,Elfsborg,4,0,4,3,5,1.69,1.19,6,3,5,2,0,3,0,3,0,2,2.25,1.5,3,0,3,2,0,1,0,1,3,3,1.13,0.88,3,3,2,0,0
Sweden - Allsvenskan,GAIS,0,5,2,5,4,1.5,0.81,5,9,2,0,0,0,1,2,2,2,1.29,0.86,2,4,1,0,0,0,4,0,3,2,1.67,0.78,3,5,1,0,0
Sweden - Allsvenskan,Hacken,1,3,4,3,5,1.5,1.56,5,3,3,4,1,1,2,2,2,1,2.0,1.88,2,2,0,3,1,0,1,2,1,4,1.0,1.25,3,1,3,1,0
Sweden - Allsvenskan,Halmstad,1,0,1,8,6,0.88,1.94,5,2,2,4,3,1,0,1,5,2,1.22,1.89,4,0,1,2,2,0,0,0,3,4,0.43,2.0,1,2,1,2,1
Sweden - Allsvenskan,Hammarby,1,3,6,6,1,1.82,0.82,10,2,3,2,0,1,2,3,4,0,2.0,0.7,6,1,3,0,0,0,1,3,2,1,1.57,1.0,4,1,0,2,0
Sweden - Allsvenskan,IFK Goteborg,0,4,1,7,4,1.31,1.38,4,6,3,2,1,0,1,1,5,1,1.25,1.25,2,3,2,1,0,0,3,0,2,3,1.38,1.5,2,3,1,1,1
Sweden - Allsvenskan,Malmo FF,1,3,4,4,5,1.47,0.71,8,6,3,0,0,0,3,2,2,1,1.88,0.63,4,3,1,0,0,1,0,2,2,4,1.11,0.78,4,3,2,0,0
Sweden - Allsvenskan,Mjallby,1,4,5,7,0,1.94,0.76,6,9,2,0,0,1,1,2,4,0,1.88,0.5,4,4,0,0,0,0,3,3,3,0,2.0,1.0,2,5,2,0,0
Sweden - Allsvenskan,Norrkoping,1,4,2,5,4,1.56,1.81,1,7,3,4,1,1,2,1,2,3,1.56,1.78,1,3,2,3,0,0,2,1,3,1,1.57,1.86,0,4,1,1,1
Sweden - Allsvenskan,Oster,0,1,3,3,9,0.75,1.44,2,8,4,1,1,0,0,2,1,5,0.63,1.38,1,4,2,1,0,0,1,1,2,4,0.88,1.5,1,4,2,0,1
Sweden - Allsvenskan,Sirius,0,2,4,7,3,1.31,1.75,1,7,4,3,1,0,1,1,3,3,1.0,1.38,1,4,2,1,0,0,1,3,4,0,1.63,2.13,0,3,2,2,1
Sweden - Allsvenskan,Varnamo,0,0,3,7,6,0.81,1.75,2,5,5,3,1,0,0,1,5,2,0.88,1.38,2,2,3,1,0,0,0,2,2,4,0.75,2.13,0,3,2,2,1
Sweden - Superettan,Brage,0,2,5,5,3,1.4,1.53,3,2,9,1,0,0,1,1,3,2,1.14,1.86,0,1,6,0,0,0,1,4,2,1,1.63,1.25,3,1,3,1,0
Sweden - Superettan,Falkenberg,1,1,8,2,3,1.67,1.4,6,2,4,1,2,1,0,5,0,1,2.0,1.0,3,1,3,0,0,0,1,3,2,2,1.38,1.75,3,1,1,1,2
Sweden - Superettan,GIF Sundsvall,1,0,5,5,4,1.27,0.93,6,4,5,0,0,1,0,2,3,2,1.38,1.38,2,1,5,0,0,0,0,3,2,2,1.14,0.43,4,3,0,0,0
Sweden - Superettan,Helsingborg,1,1,5,3,5,1.4,1.27,6,3,4,1,1,1,0,1,3,2,1.43,1.43,3,1,2,0,1,0,1,4,0,3,1.38,1.13,3,2,2,1,0
Sweden - Superettan,Kalmar,1,2,7,2,3,1.8,0.93,7,3,4,1,0,0,1,5,1,0,2.0,1.0,4,0,2,1,0,1,1,2,1,3,1.63,0.88,3,3,2,0,0
Sweden - Superettan,Landskrona,0,2,7,4,2,1.6,1.67,3,5,2,4,1,0,1,2,4,1,1.38,1.5,2,2,2,2,0,0,1,5,0,1,1.86,1.86,1,3,0,2,1
Sweden - Superettan,Oddevold,0,1,7,5,2,1.47,1.27,5,5,3,1,1,0,0,2,5,1,1.13,1.88,1,3,2,1,1,0,1,5,0,1,1.86,0.57,4,2,1,0,0
Sweden - Superettan,Orebro,1,1,1,6,6,1.0,2.0,1,3,7,3,1,0,1,1,1,4,0.86,1.71,1,1,4,1,0,1,0,0,5,2,1.13,2.25,0,2,3,2,1
Sweden - Superettan,Orgryte,3,3,3,4,2,2.13,1.2,5,4,4,2,0,3,1,2,0,2,2.5,0.75,4,2,2,0,0,0,2,1,4,0,1.71,1.71,1,2,2,2,0
Sweden - Superettan,Ostersunds,0,3,4,3,5,1.33,1.27,3,7,3,2,0,0,3,2,1,1,2.0,1.71,0,4,1,2,0,0,0,2,2,4,0.75,0.88,3,3,2,0,0
Sweden - Superettan,Sandviken,1,0,6,2,6,1.2,1.47,3,7,2,1,2,1,0,3,0,4,1.25,1.13,2,4,1,1,0,0,0,3,2,2,1.14,1.86,1,3,1,0,2
Sweden - Superettan,Trelleborg,1,0,2,2,10,0.73,1.47,5,4,3,0,3,1,0,0,1,5,0.86,1.0,3,3,0,0,1,0,0,2,1,5,0.63,1.88,2,1,3,0,2
Sweden - Superettan,Umea,0,1,2,4,8,0.73,2.13,0,5,6,2,2,0,1,1,2,4,0.88,1.75,0,4,2,2,0,0,0,1,2,4,0.57,2.57,0,1,4,0,2
Sweden - Superettan,Utsikten,2,1,4,7,1,1.73,1.67,1,5,8,0,1,2,0,2,3,1,1.88,1.75,1,2,4,0,1,0,1,2,4,0,1.57,1.57,0,3,4,0,0
Sweden - Superettan,Varberg BoIS,3,0,2,8,2,1.6,1.2,6,3,5,0,1,2,0,1,3,2,1.63,0.75,4,2,2,0,0,1,0,1,5,0,1.57,1.71,2,1,3,0,1
Sweden - Superettan,Vasteras,1,1,6,4,3,1.6,1.27,5,4,5,0,1,0,0,3,4,0,1.43,1.0,3,1,3,0,0,1,1,3,0,3,1.75,1.5,2,3,2,0,1
Sweden - Sodra,Angelholm,4,0,3,4,4,2.0,1.53,2,5,6,2,0,2,0,1,3,1,2.14,1.71,0,3,3,1,0,2,0,2,1,3,1.88,1.38,2,2,3,1,0
Sweden - Sodra,Ariana,0,5,2,4,4,1.53,1.2,5,3,6,1,0,0,4,0,1,2,1.86,1.43,2,1,3,1,0,0,1,2,3,2,1.25,1.0,3,2,3,0,0
Sweden - Sodra,Eskilsminne,0,0,5,6,5,1.0,1.69,4,4,4,3,1,0,0,3,2,3,1.0,2.13,2,1,2,2,1,0,0,2,4,2,1.0,1.25,2,3,2,1,0
Sweden - Sodra,Hassleholms IF,0,3,3,5,4,1.33,1.33,3,7,3,1,1,0,2,1,3,2,1.38,1.38,1,5,1,0,1,0,1,2,2,2,1.29,1.29,2,2,2,1,0
Sweden - Sodra,Husqvarna,0,2,3,6,4,1.2,2.47,1,3,4,5,2,0,1,3,1,3,1.25,1.5,1,3,3,1,0,0,1,0,5,1,1.14,3.57,0,0,1,4,2
Sweden - Sodra,IFK Skovde,1,2,0,6,6,1.13,2.4,3,3,4,2,3,1,1,0,3,3,1.38,1.38,2,2,3,1,0,0,1,0,3,3,0.86,3.57,1,1,1,1,3
Sweden - Sodra,Jonkopings,0,3,4,4,4,1.4,0.6,8,5,2,0,0,0,2,3,3,0,1.88,0.38,5,3,0,0,0,0,1,1,1,4,0.86,0.86,3,2,2,0,0
Sweden - Sodra,Ljungskile,3,4,4,3,1,2.8,1.0,6,5,2,2,0,1,3,2,1,1,3.13,1.0,4,1,2,1,0,2,1,2,2,0,2.43,1.0,2,4,0,1,0
Sweden - Sodra,Lund,1,2,5,4,3,1.67,1.13,6,3,4,2,0,0,2,2,2,1,1.71,0.43,5,1,1,0,0,1,0,3,2,2,1.63,1.75,1,2,3,2,0
Sweden - Sodra,Norrby,2,0,5,6,2,1.6,0.93,5,6,4,0,0,2,0,3,3,0,2.13,1.25,2,2,4,0,0,0,0,2,3,2,1.0,0.57,3,4,0,0,0
Sweden - Sodra,Olympic,0,2,4,4,6,1.13,1.75,2,6,6,0,2,0,0,4,2,2,1.25,2.0,0,4,3,0,1,0,2,0,2,4,1.0,1.5,2,2,3,0,1
Sweden - Sodra,Oskarshamns,0,3,1,3,8,0.93,1.27,5,5,1,4,0,0,1,0,1,5,0.57,0.86,4,1,1,1,0,0,2,1,2,3,1.25,1.63,1,4,0,3,0
Sweden - Sodra,Rosengard,0,0,6,6,3,1.2,1.13,5,6,2,1,1,0,0,1,4,2,0.86,0.86,2,4,1,0,0,0,0,5,2,1,1.5,1.38,3,2,1,1,1
Sweden - Sodra,Skovde AIK,1,2,5,5,2,1.67,2.07,3,3,3,4,2,1,2,1,3,0,2.14,1.86,1,2,2,1,1,0,0,4,2,2,1.25,2.25,2,1,1,3,1
Sweden - Sodra,Torslanda,2,2,4,1,6,1.67,1.2,6,5,1,1,2,1,2,2,1,2,1.88,0.88,4,3,0,0,1,1,0,2,0,4,1.43,1.57,2,2,1,1,1
Sweden - Sodra,Trollhattan,2,2,2,4,5,1.6,2.07,3,2,4,4,2,2,1,0,1,3,2.0,2.0,2,1,1,2,1,0,1,2,3,2,1.25,2.13,1,1,3,2,1
Switzerland - Super League,BSC Young Boys,0,0,0,0,0,,,0,0,0,0,0,0,0,0,0,0,,,0,0,0,0,0,0,0,0,0,0,,,0,0,0,0,0
Switzerland - Super League,FC Basel,0,0,0,0,0,,,0,0,0,0,0,0,0,0,0,0,,,0,0,0,0,0,0,0,0,0,0,,,0,0,0,0,0
Switzerland - Super League,FC Zurich,0,0,0,0,0,,,0,0,0,0,0,0,0,0,0,0,,,0,0,0,0,0,0,0,0,0,0,,,0,0,0,0,0
Switzerland - Super League,Grasshopper,0,0,0,0,0,,,0,0,0,0,0,0,0,0,0,0,,,0,0,0,0,0,0,0,0,0,0,,,0,0,0,0,0
Switzerland - Super League,Lausanne Sport,0,0,0,0,0,,,0,0,0,0,0,0,0,0,0,0,,,0,0,0,0,0,0,0,0,0,0,,,0,0,0,0,0
Switzerland - Super League,Lugano,0,0,0,0,0,,,0,0,0,0,0,0,0,0,0,0,,,0,0,0,0,0,0,0,0,0,0,,,0,0,0,0,0
Switzerland - Super League,Luzern,0,0,0,0,0,,,0,0,0,0,0,0,0,0,0,0,,,0,0,0,0,0,0,0,0,0,0,,,0,0,0,0,0
Switzerland - Super League,Servette,0,0,0,0,0,,,0,0,0,0,0,0,0,0,0,0,,,0,0,0,0,0,0,0,0,0,0,,,0,0,0,0,0
Switzerland - Super League,Sion,0,0,0,0,0,,,0,0,0,0,0,0,0,0,0,0,,,0,0,0,0,0,0,0,0,0,0,,,0,0,0,0,0
Switzerland - Super League,St. Gallen,0,0,0,0,0,,,0,0,0,0,0,0,0,0,0,0,,,0,0,0,0,0,0,0,0,0,0,,,0,0,0,0,0
Switzerland - Super League,Thun,0,0,0,0,0,,,0,0,0,0,0,0,0,0,0,0,,,0,0,0,0,0,0,0,0,0,0,,,0,0,0,0,0
Switzerland - Super League,Winterthur,0,0,0,0,0,,,0,0,0,0,0,0,0,0,0,0,,,0,0,0,0,0,0,0,0,0,0,,,0,0,0,0,0
Switzerland - Challenge League,Aarau,0,0,0,0,0,,,0,0,0,0,0,0,0,0,0,0,,,0,0,0,0,0,0,0,0,0,0,,,0,0,0,0,0
Switzerland - Challenge League,Bellinzona,0,0,0,0,0,,,0,0,0,0,0,0,0,0,0,0,,,0,0,0,0,0,0,0,0,0,0,,,0,0,0,0,0
Switzerland - Challenge League,Etoile Carouge,0,0,0,0,0,,,0,0,0,0,0,0,0,0,0,0,,,0,0,0,0,0,0,0,0,0,0,,,0,0,0,0,0
Switzerland - Challenge League,Lausanne Ouchy,0,0,0,0,0,,,0,0,0,0,0,0,0,0,0,0,,,0,0,0,0,0,0,0,0,0,0,,,0,0,0,0,0
Switzerland - Challenge League,Neuchatel Xamax,0,0,0,0,0,,,0,0,0,0,0,0,0,0,0,0,,,0,0,0,0,0,0,0,0,0,0,,,0,0,0,0,0
Switzerland - Challenge League,Rapperswil,0,0,0,0,0,,,0,0,0,0,0,0,0,0,0,0,,,0,0,0,0,0,0,0,0,0,0,,,0,0,0,0,0
Switzerland - Challenge League,Stade Nyonnais,0,0,0,0,0,,,0,0,0,0,0,0,0,0,0,0,,,0,0,0,0,0,0,0,0,0,0,,,0,0,0,0,0
Switzerland - Challenge League,Vaduz,0,0,0,0,0,,,0,0,0,0,0,0,0,0,0,0,,,0,0,0,0,0,0,0,0,0,0,,,0,0,0,0,0
Switzerland - Challenge League,Wil,0,0,0,0,0,,,0,0,0,0,0,0,0,0,0,0,,,0,0,0,0,0,0,0,0,0,0,,,0,0,0,0,0
Switzerland - Challenge League,Yverdon,0,0,0,0,0,,,0,0,0,0,0,0,0,0,0,0,,,0,0,0,0,0,0,0,0,0,0,,,0,0,0,0,0
Thailand - Thai League 1,Bangkok Utd,3,9,9,5,4,2.1,1.0,11,10,8,0,1,2,4,5,2,2,2.2,0.87,6,5,4,0,0,1,5,4,3,2,2.0,1.13,5,5,4,0,1
Thailand - Thai League 1,Buriram Utd,10,4,8,5,3,3.07,0.67,16,10,2,2,0,7,1,2,4,1,3.73,0.47,10,3,2,0,0,3,3,6,1,2,2.4,0.87,6,7,0,2,0
Thailand - Thai League 1,Chiangrai Utd,1,3,5,10,11,1.1,1.7,9,7,7,4,3,0,2,3,6,4,1.2,0.87,8,4,2,0,1,1,1,2,4,7,1.0,2.53,1,3,5,4,2
Thailand - Thai League 1,Khon Kaen Utd,1,1,3,8,17,0.7,2.27,6,9,4,4,7,1,1,2,3,8,0.93,1.87,3,6,1,3,2,0,0,1,5,9,0.47,2.67,3,3,3,1,5
Thailand - Thai League 1,Lamphun Warrior,1,5,2,13,9,1.2,1.3,9,10,7,2,2,1,3,1,7,3,1.47,1.2,6,4,3,1,1,0,2,1,6,6,0.93,1.4,3,6,4,1,1
Thailand - Thai League 1,Muang Thong Utd,4,2,6,11,7,1.53,1.3,7,12,8,2,1,2,1,6,4,2,1.8,0.93,6,5,3,1,0,2,1,0,7,5,1.27,1.67,1,7,5,1,1
Thailand - Thai League 1,N. Bua Pitchaya,2,2,3,14,9,1.23,2.07,4,9,7,5,5,2,1,2,6,4,1.6,1.47,3,6,3,2,1,0,1,1,8,5,0.87,2.67,1,3,4,3,4
Thailand - Thai League 1,N. Ratchasima,0,3,8,11,8,1.2,1.9,3,13,5,4,5,0,3,4,7,1,1.6,1.93,1,7,2,3,2,0,0,4,4,7,0.8,1.87,2,6,3,1,3
Thailand - Thai League 1,Nakhon Pathom,0,2,5,14,9,1.0,1.97,4,8,8,7,3,0,0,4,8,3,1.07,2.27,1,5,3,3,3,0,2,1,6,6,0.93,1.67,3,3,5,4,0
Thailand - Thai League 1,Pathum Utd,3,3,7,12,5,1.57,1.13,8,15,4,1,2,2,1,3,7,2,1.6,0.87,7,5,2,0,1,1,2,4,5,3,1.53,1.4,1,10,2,1,1
Thailand - Thai League 1,Port FC,4,3,10,6,7,1.73,1.3,5,14,8,3,0,4,1,3,4,3,2.0,1.2,3,7,4,1,0,0,2,7,2,4,1.47,1.4,2,7,4,2,0
Thailand - Thai League 1,Prachuap,3,3,9,9,6,1.63,1.3,11,8,6,3,2,2,3,5,4,1,2.13,0.93,8,2,4,0,1,1,0,4,5,5,1.13,1.67,3,6,2,3,1
Thailand - Thai League 1,Ratchaburi,6,4,8,8,4,2.17,1.57,8,9,7,3,3,3,2,5,5,0,2.2,1.07,6,3,5,1,0,3,2,3,3,4,2.13,2.07,2,6,2,2,3
Thailand - Thai League 1,Rayong,1,3,7,14,5,1.37,1.97,4,9,5,8,4,1,2,5,6,1,1.73,1.73,2,6,2,4,1,0,1,2,8,4,1.0,2.2,2,3,3,4,3
Thailand - Thai League 1,Sukhothai,3,3,6,13,5,1.57,1.8,7,6,7,6,4,2,3,3,6,1,2.0,1.53,5,2,3,5,0,1,0,3,7,4,1.13,2.07,2,4,4,1,4
Thailand - Thai League 1,Uthai Thani,0,7,3,10,10,1.23,1.17,7,14,6,3,0,0,5,1,6,3,1.53,0.8,5,8,2,0,0,0,2,2,4,7,0.93,1.53,2,6,4,3,0
Thailand - Thai League 2,Ayutthaya Utd,4,2,13,6,7,1.78,0.94,12,12,6,2,0,2,1,10,2,1,2.19,0.75,7,6,3,0,0,2,1,3,4,6,1.38,1.13,5,6,3,2,0
Thailand - Thai League 2,Bangkok FC,2,3,7,11,9,1.31,1.56,4,14,9,3,2,0,1,4,8,3,1.19,1.13,4,7,4,1,0,2,2,3,3,6,1.44,2.0,0,7,5,2,2
Thailand - Thai League 2,Chainat,1,1,6,12,12,1.0,1.06,8,15,8,1,0,1,1,5,5,4,1.44,1.0,5,7,3,1,0,0,0,1,7,8,0.56,1.13,3,8,5,0,0
Thailand - Thai League 2,Chanthaburi,0,3,6,17,6,1.19,1.41,8,12,8,2,2,0,2,2,11,1,1.31,1.0,6,4,6,0,0,0,1,4,6,5,1.06,1.81,2,8,2,2,2
Thailand - Thai League 2,Chiangmai Utd,1,3,7,14,7,1.28,1.5,6,14,6,4,2,1,1,4,7,3,1.38,1.38,3,8,3,1,1,0,2,3,7,4,1.19,1.63,3,6,3,3,1
Thailand - Thai League 2,Chonburi,4,1,12,11,4,1.75,0.94,11,13,7,1,0,4,0,8,3,1,2.31,0.88,6,6,4,0,0,0,1,4,8,3,1.19,1.0,5,7,3,1,0
Thailand - Thai League 2,Kanchanaburi,2,5,11,7,7,1.66,1.13,12,10,4,6,0,1,1,5,4,5,1.38,0.94,8,4,1,3,0,1,4,6,3,2,1.94,1.31,4,6,3,3,0
Thailand - Thai League 2,Kasetsart,0,3,7,13,9,1.13,1.16,11,9,8,4,0,0,1,4,5,6,1.0,0.75,9,3,3,1,0,0,2,3,8,3,1.25,1.56,2,6,5,3,0
Thailand - Thai League 2,Lampang,0,6,10,10,6,1.5,1.22,11,10,7,1,3,0,6,5,2,3,1.88,1.06,6,7,1,0,2,0,0,5,8,3,1.13,1.38,5,3,6,1,1
Thailand - Thai League 2,Mahasarakham,1,4,9,10,8,1.38,1.22,10,8,12,1,1,1,3,5,6,1,1.81,1.38,5,3,6,1,1,0,1,4,4,7,0.94,1.06,5,5,6,0,0
Thailand - Thai League 2,Nakhon Si,4,3,4,12,9,1.5,1.66,6,10,10,3,3,3,3,3,5,2,2.13,1.44,3,7,4,1,1,1,0,1,7,7,0.88,1.88,3,3,6,2,2
Thailand - Thai League 2,Pattaya United,1,1,5,13,12,1.0,1.47,8,11,5,7,1,0,1,1,7,7,0.75,1.38,4,7,0,5,0,1,0,4,6,5,1.25,1.56,4,4,5,2,1
Thailand - Thai League 2,Phrae Utd,6,4,3,15,4,1.91,1.19,13,5,11,1,2,4,2,2,6,2,2.25,1.0,8,2,5,0,1,2,2,1,9,2,1.56,1.38,5,3,6,1,1
Thailand - Thai League 2,Police Tero,1,1,10,12,8,1.22,1.5,7,11,8,3,3,0,1,6,5,4,1.25,0.88,5,8,3,0,0,1,0,4,7,4,1.19,2.13,2,3,5,3,3
Thailand - Thai League 2,Samut Prakan,0,0,0,0,0,,,0,0,0,0,0,0,0,0,0,0,,,0,0,0,0,0,0,0,0,0,0,,,0,0,0,0,0
Thailand - Thai League 2,Sisaket Utd,0,1,7,12,12,0.91,1.22,9,16,3,2,2,0,0,7,5,4,1.19,0.88,5,9,1,1,0,0,1,0,7,8,0.63,1.56,4,7,2,1,2
Thailand - Thai League 2,Suphanburi,1,6,5,8,12,1.31,2.25,2,10,9,6,5,1,4,2,3,6,1.56,2.0,1,7,3,3,2,0,2,3,5,6,1.06,2.5,1,3,6,3,3
Thailand - Thai League 2,Trat FC,1,2,7,10,12,1.13,1.53,6,13,8,2,3,1,2,4,8,1,1.75,1.31,5,6,2,1,2,0,0,3,2,11,0.5,1.75,1,7,6,1,1
Turkey - Super Lig,Adana Demirspor,0,3,7,11,15,0.94,2.56,2,9,8,8,9,0,1,3,5,9,0.78,2.33,1,6,5,1,5,0,2,4,6,6,1.11,2.78,1,3,3,7,4
Turkey - Super Lig,Alanyaspor,1,3,6,17,9,1.19,1.39,9,13,8,3,3,1,2,3,9,3,1.44,1.17,5,7,5,0,1,0,1,3,8,6,0.94,1.61,4,6,3,3,2
Turkey - Super Lig,Antalyaspor,0,3,10,8,15,1.03,1.72,7,11,10,3,5,0,2,7,3,6,1.28,1.22,5,7,4,1,1,0,1,3,5,9,0.78,2.22,2,4,6,2,4
Turkey - Super Lig,Basaksehir,6,3,7,12,8,1.67,1.56,10,9,8,6,3,4,1,4,6,3,1.89,1.28,6,5,4,2,1,2,2,3,6,5,1.44,1.83,4,4,4,4,2
Turkey - Super Lig,Besiktas,4,2,10,16,4,1.64,1.0,11,17,6,1,1,3,0,8,5,2,1.89,1.22,5,7,4,1,1,1,2,2,11,2,1.39,0.78,6,10,2,0,0
Turkey - Super Lig,Bodrumspor,0,2,4,12,18,0.72,1.19,14,11,5,2,4,0,2,2,5,9,0.83,1.06,6,9,1,0,2,0,0,2,7,9,0.61,1.33,8,2,4,2,2
Turkey - Super Lig,Eyupspor,3,3,5,19,6,1.44,1.31,11,11,8,5,1,2,3,3,8,2,1.83,1.28,7,5,2,3,1,1,0,2,11,4,1.06,1.33,4,6,6,2,0
Turkey - Super Lig,Fenerbahce,7,12,10,3,4,2.5,1.08,12,13,8,2,1,2,8,4,2,2,2.33,1.0,6,8,2,2,0,5,4,6,1,2,2.67,1.17,6,5,6,0,1
Turkey - Super Lig,Galatasaray,7,9,13,6,1,2.53,0.86,15,14,4,3,0,4,5,6,2,1,2.56,0.83,9,5,2,2,0,3,4,7,4,0,2.5,0.89,6,9,2,1,0
Turkey - Super Lig,Gaziantep,0,3,12,12,9,1.25,1.39,9,12,7,8,0,0,3,5,5,5,1.33,0.78,7,9,1,1,0,0,0,7,7,4,1.17,2.0,2,3,6,7,0
Turkey - Super Lig,Goztepe,3,6,8,12,7,1.64,1.39,8,16,7,2,3,2,4,5,5,2,2.0,0.89,6,8,4,0,0,1,2,3,7,5,1.28,1.89,2,8,3,2,3
Turkey - Super Lig,Hatayspor,3,2,7,14,10,1.31,2.06,3,13,8,7,5,1,2,3,8,4,1.33,1.72,1,9,3,4,1,2,0,4,6,6,1.28,2.39,2,4,5,3,4
Turkey - Super Lig,Kasimpasa,2,7,11,9,7,1.72,1.75,7,9,10,7,3,1,3,6,5,3,1.72,1.83,3,4,6,3,2,1,4,5,4,4,1.72,1.67,4,5,4,4,1
Turkey - Super Lig,Kayserispor,1,4,8,12,11,1.25,1.58,10,10,8,5,3,1,3,4,6,4,1.56,1.44,7,4,4,1,2,0,1,4,6,7,0.94,1.72,3,6,4,4,1
Turkey - Super Lig,Konyaspor,0,6,5,17,8,1.25,1.39,8,12,10,6,0,0,4,3,8,3,1.44,1.06,6,7,3,2,0,0,2,2,9,5,1.06,1.72,2,5,7,4,0
Turkey - Super Lig,Rizespor,2,5,8,10,11,1.44,1.61,4,16,10,4,2,2,4,2,6,4,1.83,1.39,3,9,4,1,1,0,1,6,4,7,1.06,1.83,1,7,6,3,1
Turkey - Super Lig,Samsunspor,3,4,12,7,10,1.53,1.14,14,9,8,4,1,2,2,8,2,4,1.78,1.17,6,5,5,2,0,1,2,4,5,6,1.28,1.11,8,4,3,2,1
Turkey - Super Lig,Sivasspor,3,3,6,9,15,1.22,1.67,6,11,11,5,3,2,3,3,4,6,1.61,1.22,5,6,5,2,0,1,0,3,5,9,0.83,2.11,1,5,6,3,3
Turkey - Super Lig,Trabzonspor,4,4,6,16,6,1.61,1.25,14,6,11,3,2,4,2,5,6,1,2.22,1.22,7,2,7,2,0,0,2,1,10,5,1.0,1.28,7,4,4,1,2
Turkey - 1,Adanaspor,1,2,6,10,19,0.84,1.97,8,13,5,3,9,0,2,3,6,8,0.95,2.11,3,7,3,1,5,1,0,3,4,11,0.74,1.84,5,6,2,2,4
Turkey - 1,Amed SK,3,2,6,13,14,1.13,0.92,15,14,7,1,1,2,2,4,6,5,1.47,0.89,8,7,3,0,1,1,0,2,7,9,0.79,0.95,7,7,4,1,0
Turkey - 1,Ankaragucu,2,5,8,10,13,1.29,1.26,10,13,11,3,1,2,2,6,3,6,1.53,1.0,8,6,3,1,1,0,3,2,7,7,1.05,1.53,2,7,8,2,0
Turkey - 1,Bandirmaspor,0,4,13,14,7,1.37,1.18,13,11,10,2,2,0,3,8,6,2,1.63,0.95,9,3,6,1,0,0,1,5,8,5,1.11,1.42,4,8,4,1,2
Turkey - 1,Boluspor,4,3,10,12,9,1.74,1.05,13,14,7,4,0,1,3,4,6,5,1.74,0.84,9,6,2,2,0,3,0,6,6,4,1.74,1.26,4,8,5,2,0
Turkey - 1,Corum,2,6,7,9,14,1.29,1.18,10,14,11,3,0,1,5,3,6,4,1.63,1.11,5,8,5,1,0,1,1,4,3,10,0.95,1.26,5,6,6,2,0
Turkey - 1,Erokspor,2,4,9,15,8,1.39,1.32,7,17,10,3,1,1,3,4,9,2,1.58,1.21,2,12,4,1,0,1,1,5,6,6,1.21,1.42,5,5,6,2,1
Turkey - 1,Erzurum BB,2,3,11,11,11,1.39,0.82,19,12,3,3,1,1,1,5,9,3,1.37,0.74,12,3,2,1,1,1,2,6,2,8,1.42,0.89,7,9,1,2,0
Turkey - 1,F. Karagumruk,3,4,7,15,9,1.45,0.95,14,12,12,0,0,3,1,2,9,4,1.58,0.74,10,4,5,0,0,0,3,5,6,5,1.32,1.16,4,8,7,0,0
Turkey - 1,Genclerbirligi,2,6,7,15,8,1.5,0.89,18,12,4,3,1,0,3,3,11,2,1.37,0.58,10,7,2,0,0,2,3,4,4,6,1.63,1.21,8,5,2,3,1
Turkey - 1,Igdir,5,4,2,14,13,1.5,0.87,21,6,7,3,1,3,3,1,7,5,1.68,0.58,11,5,3,0,0,2,1,1,7,8,1.32,1.16,10,1,4,3,1
Turkey - 1,Istanbulspor,6,7,3,13,9,1.76,1.0,17,8,9,4,0,5,6,1,3,4,2.42,0.68,13,0,5,1,0,1,1,2,10,5,1.11,1.32,4,8,4,3,0
Turkey - 1,Keciorengucu,3,2,14,11,8,1.58,1.39,10,14,5,7,2,3,2,6,5,3,2.0,1.47,4,7,3,5,0,0,0,8,6,5,1.16,1.32,6,7,2,2,2
Turkey - 1,Kocaelispor,3,7,10,12,6,1.79,1.08,14,15,4,2,3,2,4,5,6,2,2.05,0.89,8,7,3,0,1,1,3,5,6,4,1.53,1.26,6,8,1,2,2
Turkey - 1,Manisa BB,2,2,13,7,14,1.32,1.37,8,15,9,5,1,1,0,7,3,8,1.16,1.21,4,8,6,1,0,1,2,6,4,6,1.47,1.53,4,7,3,4,1
Turkey - 1,Pendikspor,3,2,8,11,14,1.18,1.34,11,11,11,3,2,1,1,5,6,6,1.21,1.0,7,5,7,0,0,2,1,3,5,8,1.16,1.68,4,6,4,3,2
Turkey - 1,Sakaryaspor,1,2,12,13,10,1.26,1.42,11,11,7,7,2,1,1,8,6,3,1.58,1.0,7,7,3,2,0,0,1,4,7,7,0.95,1.84,4,4,4,5,2
Turkey - 1,Sanliurfaspor,2,6,4,11,15,1.18,1.45,7,14,11,5,1,0,6,1,4,8,1.26,1.37,4,7,5,3,0,2,0,3,7,7,1.11,1.53,3,7,6,2,1
Turkey - 1,Umraniyespor,2,5,5,13,13,1.26,1.11,14,11,8,5,0,1,3,4,6,5,1.47,0.84,8,7,3,1,0,1,2,1,7,8,1.05,1.37,6,4,5,4,0
Turkey - 1,Y. Malatyaspor,0,0,2,10,26,0.37,4.03,0,2,6,10,20,0,0,2,4,13,0.42,3.89,0,2,2,4,11,0,0,0,6,13,0.32,4.16,0,0,4,6,9
UAE - Pro League,Ajman,4,0,8,7,7,1.54,1.77,5,8,3,8,2,4,0,5,2,2,2.23,1.69,1,6,2,4,0,0,0,3,5,5,0.85,1.85,4,2,1,4,2
UAE - Pro League,Al Ain,5,7,5,4,5,2.15,1.23,8,9,5,3,1,4,2,1,3,3,2.15,0.85,4,7,2,0,0,1,5,4,1,2,2.15,1.62,4,2,3,3,1
UAE - Pro League,Al Bataeh,0,3,3,15,5,1.15,1.73,6,5,6,8,1,0,2,1,7,3,1.15,2.08,3,1,2,6,1,0,1,2,8,2,1.15,1.38,3,4,4,2,0
UAE - Pro League,Al Jazira,4,3,4,9,6,1.73,1.54,6,8,8,1,3,2,1,2,5,3,1.54,1.31,5,3,3,1,1,2,2,2,4,3,1.92,1.77,1,5,5,0,2
UAE - Pro League,Al Nasr,3,6,4,6,7,1.73,1.73,3,9,7,6,1,1,4,3,1,4,1.77,1.31,1,8,3,1,0,2,2,1,5,3,1.69,2.15,2,1,4,5,1
UAE - Pro League,Al Sharjah,6,1,3,11,5,1.69,0.85,13,6,5,2,0,3,1,2,4,3,1.77,0.62,8,3,1,1,0,3,0,1,7,2,1.62,1.08,5,3,4,1,0
UAE - Pro League,Al Urooba,1,1,3,11,10,0.92,2.46,1,5,10,5,5,1,0,2,8,2,1.23,2.46,1,3,4,1,4,0,1,1,3,8,0.62,2.46,0,2,6,4,1
UAE - Pro League,Al Wahda,2,7,9,4,4,1.96,1.23,9,7,8,0,2,1,4,6,1,1,2.23,1.23,3,4,6,0,0,1,3,3,3,3,1.69,1.23,6,3,2,0,2
UAE - Pro League,Al Wasl,2,6,8,6,4,1.96,1.35,8,8,6,1,3,1,4,4,3,1,2.23,1.08,4,6,2,0,1,1,2,4,3,3,1.69,1.62,4,2,4,1,2
UAE - Pro League,Bani Yas,0,3,7,7,9,1.15,2.04,5,7,4,4,6,0,2,4,3,4,1.31,2.08,3,3,1,3,3,0,1,3,4,5,1.0,2.0,2,4,3,1,3
UAE - Pro League,Dibba Al Hisn,1,1,6,10,8,1.12,2.15,1,9,8,4,4,0,1,2,5,5,0.92,2.23,1,3,5,2,2,1,0,4,5,3,1.31,2.08,0,6,3,2,2
UAE - Pro League,Ittihad Kalba,0,5,9,6,6,1.5,1.46,5,9,7,5,0,0,4,4,2,3,1.69,1.38,2,6,3,2,0,0,1,5,4,3,1.31,1.54,3,3,4,3,0
UAE - Pro League,Khorfakkan,2,4,5,10,5,1.58,2.0,4,8,4,5,5,1,2,3,4,3,1.62,1.54,2,5,4,1,1,1,2,2,6,2,1.54,2.46,2,3,0,4,4
UAE - Pro League,Shabab Al Ahli,4,5,10,4,3,2.19,0.85,10,12,3,0,1,2,3,6,0,2,2.31,0.77,7,4,1,0,1,2,2,4,4,1,2.08,0.92,3,8,2,0,0
Ukraine - Premier League,Chornomorets,0,0,2,16,12,0.67,1.5,5,14,4,5,2,0,0,0,9,6,0.6,1.2,5,6,1,2,1,0,0,2,7,6,0.73,1.8,0,8,3,3,1
Ukraine - Premier League,Dnipro-1,0,0,0,0,0,,,0,0,0,0,0,0,0,0,0,0,,,0,0,0,0,0,0,0,0,0,0,,,0,0,0,0,0
Ukraine - Premier League,Dynamo Kyiv,3,6,11,7,3,2.03,0.63,14,13,3,0,0,1,4,5,4,1,2.07,0.67,7,6,2,0,0,2,2,6,3,2,2.0,0.6,7,7,1,0,0
Ukraine - Premier League,Inhulets,0,1,4,10,15,0.7,1.57,9,9,7,0,5,0,0,2,5,8,0.6,1.2,5,6,2,0,2,0,1,2,5,7,0.8,1.93,4,3,5,0,3
Ukraine - Premier League,Karpaty Lviv,2,4,4,13,7,1.4,1.2,13,5,7,4,1,2,3,1,7,2,1.8,0.8,9,3,0,3,0,0,1,3,6,5,1.0,1.6,4,2,7,1,1
Ukraine - Premier League,Kolos Kovalivka,1,1,4,12,12,0.9,0.83,11,13,6,0,0,0,0,1,6,8,0.53,0.73,5,9,1,0,0,1,1,3,6,4,1.27,0.93,6,4,5,0,0
Ukraine - Premier League,Kryvbas KR,1,4,2,14,9,1.13,0.87,12,12,4,2,0,1,3,1,6,4,1.4,0.93,5,7,2,1,0,0,1,1,8,5,0.87,0.8,7,5,2,1,0
Ukraine - Premier League,LNZ Cherkasy,0,1,4,14,11,0.83,1.23,8,14,4,2,2,0,1,3,6,5,1.0,1.07,5,6,3,0,1,0,0,1,8,6,0.67,1.4,3,8,1,2,1
Ukraine - Premier League,Livyi Bereh,0,2,2,8,18,0.6,1.3,8,11,6,4,1,0,1,2,4,8,0.73,1.27,4,6,2,3,0,0,1,0,4,10,0.47,1.33,4,5,4,1,1
Ukraine - Premier League,Obolon,0,1,4,8,17,0.63,1.43,11,7,6,1,5,0,0,3,4,8,0.67,1.27,7,2,4,0,2,0,1,1,4,9,0.6,1.6,4,5,2,1,3
Ukraine - Premier League,Oleksandria,2,4,7,12,5,1.53,0.73,15,11,1,3,0,2,3,4,5,1,2.0,0.6,8,6,0,1,0,0,1,3,7,4,1.07,0.87,7,5,1,2,0
Ukraine - Premier League,Polessya,2,2,3,18,5,1.27,0.93,10,16,2,1,1,1,1,2,8,3,1.27,0.8,4,10,1,0,0,1,1,1,10,2,1.27,1.07,6,6,1,1,1
Ukraine - Premier League,Rukh Lviv,2,1,2,14,11,1.0,0.9,12,12,3,3,0,1,1,1,6,6,1.07,0.8,6,7,1,1,0,1,0,1,8,5,0.93,1.0,6,5,2,2,0
Ukraine - Premier League,Shakhtar,7,6,5,8,4,2.3,0.87,12,14,2,0,2,4,4,3,3,1,2.73,1.0,5,7,2,0,1,3,2,2,5,3,1.87,0.73,7,7,0,0,1
Ukraine - Premier League,Veres,1,1,8,9,11,1.1,1.47,6,11,8,4,1,1,0,6,5,3,1.47,1.33,2,7,5,1,0,0,1,2,4,8,0.73,1.6,4,4,3,3,1
Ukraine - Premier League,Vorskla Poltava,0,2,3,12,13,0.8,1.27,10,9,6,4,1,0,1,2,4,8,0.73,1.4,5,4,3,2,1,0,1,1,8,5,0.87,1.13,5,5,3,2,0
Ukraine - Premier League,Zorya Luhansk,0,1,11,9,9,1.13,1.3,6,13,7,4,0,0,0,7,3,5,1.13,1.2,3,7,4,1,0,0,1,4,6,4,1.13,1.4,3,6,3,3,0
USA - MLS,Atlanta Utd,2,2,3,7,9,1.17,1.87,2,6,9,5,1,2,2,2,3,3,1.75,1.67,1,4,5,2,0,0,0,1,4,6,0.55,2.09,1,2,4,3,1
USA - MLS,Austin,0,0,4,9,9,0.77,1.09,8,8,4,1,1,0,0,2,4,5,0.73,0.73,5,5,0,1,0,0,0,2,5,4,0.82,1.45,3,3,4,0,1
USA - MLS,CF Montreal,0,1,3,11,9,0.83,1.88,4,7,6,4,3,0,0,1,6,4,0.73,2.18,2,2,3,2,2,0,1,2,5,5,0.92,1.62,2,5,3,2,1
USA - MLS,Charlotte,1,3,11,6,3,1.71,1.63,6,5,8,2,3,1,2,6,1,1,2.09,1.09,4,4,2,0,1,0,1,5,5,2,1.38,2.08,2,1,6,2,2
USA - MLS,Chicago Fire,2,4,8,5,4,1.91,1.74,3,9,7,2,2,0,1,3,2,4,1.1,1.4,2,3,4,1,0,2,3,5,3,0,2.54,2.0,1,6,3,1,2
USA - MLS,Cincinnati,0,4,9,9,2,1.63,1.29,8,8,4,1,3,0,2,6,3,0,1.91,1.27,4,3,2,1,1,0,2,3,6,2,1.38,1.31,4,5,2,0,2
USA - MLS,Colorado Rapids,0,5,4,7,8,1.25,1.5,7,3,9,5,0,0,3,2,4,4,1.31,1.23,5,2,4,2,0,0,2,2,3,4,1.18,1.82,2,1,5,3,0
USA - MLS,Columbus Crew,3,1,9,7,4,1.67,1.38,4,12,5,2,1,2,1,5,2,3,1.77,1.0,3,7,3,0,0,1,0,4,5,1,1.55,1.82,1,5,2,2,1
USA - MLS,DC United,0,0,6,8,10,0.83,1.88,4,7,9,1,3,0,0,3,3,6,0.75,1.5,3,5,3,0,1,0,0,3,5,4,0.92,2.25,1,2,6,1,2
USA - MLS,Dallas,2,3,5,5,8,1.39,1.78,4,7,5,5,2,0,1,3,3,4,1.09,1.64,2,4,2,2,1,2,2,2,2,4,1.67,1.92,2,3,3,3,1
USA - MLS,Houston Dynamo,1,2,4,12,5,1.25,1.63,8,3,4,8,1,0,0,3,9,1,1.15,1.77,4,1,3,4,1,1,2,1,3,4,1.36,1.45,4,2,1,4,0
USA - MLS,Inter Miami,6,3,5,4,3,2.33,1.62,3,10,2,4,2,3,1,3,2,1,2.4,1.6,1,5,2,1,1,3,2,2,2,2,2.27,1.64,2,5,0,3,1
USA - MLS,LA Galaxy,0,3,6,7,8,1.17,2.0,2,7,9,4,2,0,1,4,3,3,1.27,1.64,2,3,4,1,1,0,2,2,4,5,1.08,2.31,0,4,5,3,1
USA - MLS,Los Angeles FC,1,4,10,3,3,1.86,1.29,8,5,4,3,1,1,3,4,2,2,1.92,0.75,6,4,1,1,0,0,1,6,1,1,1.78,2.0,2,1,3,2,1
USA - MLS,Minnesota Utd,2,5,6,5,6,1.67,1.13,8,9,4,2,1,2,2,3,3,2,1.92,1.17,4,5,1,1,1,0,3,3,2,4,1.42,1.08,4,4,3,1,0
USA - MLS,Nashville SC,1,4,8,7,4,1.75,1.04,9,6,8,1,0,1,2,5,3,2,2.0,0.69,7,3,3,0,0,0,2,3,4,2,1.45,1.45,2,3,5,1,0
USA - MLS,New England,0,5,4,7,7,1.3,1.39,8,5,5,4,1,0,1,3,2,4,1.1,1.5,2,3,3,2,0,0,4,1,5,3,1.46,1.31,6,2,2,2,1
USA - MLS,New York City,1,3,6,5,8,1.3,1.13,7,9,5,1,1,1,2,3,3,2,1.73,0.91,4,5,1,1,0,0,1,3,2,6,0.92,1.33,3,4,4,0,1
USA - MLS,New York RB,3,0,7,9,5,1.63,1.46,7,5,9,1,2,3,0,6,3,0,2.58,1.5,4,2,4,1,1,0,0,1,6,5,0.67,1.42,3,3,5,0,1
USA - MLS,Orlando City,3,4,6,7,4,1.79,1.33,8,5,7,3,1,2,3,1,5,1,2.0,1.58,3,3,3,2,1,1,1,5,2,3,1.58,1.08,5,2,4,1,0
USA - MLS,Philadelphia,2,4,7,6,5,1.67,0.96,9,9,4,2,0,1,4,4,2,1,2.17,1.08,5,3,2,2,0,1,0,3,4,4,1.17,0.83,4,6,2,0,0
USA - MLS,Portland,2,3,3,9,6,1.39,1.39,5,10,4,2,2,0,2,3,7,1,1.46,1.23,2,9,0,1,1,2,1,0,2,5,1.3,1.6,3,1,4,1,1
USA - MLS,Real Salt Lake,0,2,5,8,8,1.04,1.26,6,9,5,2,1,0,1,4,2,4,1.18,1.0,5,3,1,2,0,0,1,1,6,4,0.92,1.5,1,6,4,0,1
USA - MLS,SJ Earthquakes,4,3,4,11,2,1.92,1.75,4,8,6,3,3,3,3,1,4,1,2.42,1.75,1,6,2,2,1,1,0,3,7,1,1.42,1.75,3,2,4,1,2
USA - MLS,San Diego,3,5,7,4,5,1.96,1.33,7,8,4,4,1,1,3,3,3,3,1.77,1.0,6,4,1,1,1,2,2,4,1,2,2.18,1.73,1,4,3,3,0
USA - MLS,Seattle,2,5,3,7,6,1.61,1.43,6,7,5,4,1,2,3,3,3,1,2.25,1.17,5,2,3,2,0,0,2,0,4,5,0.91,1.73,1,5,2,2,1
USA - MLS,Sporting KC,1,3,7,8,4,1.57,1.83,3,7,6,5,2,0,2,5,4,1,1.67,2.0,2,3,2,3,2,1,1,2,4,3,1.45,1.64,1,4,4,2,0
USA - MLS,St. Louis City,0,2,6,5,10,1.0,1.65,5,6,6,4,2,0,1,4,3,3,1.27,1.45,3,3,3,1,1,0,1,2,2,7,0.75,1.83,2,3,3,3,1
USA - MLS,Toronto,1,1,3,10,8,1.09,1.3,6,7,8,1,1,0,1,1,5,6,0.77,1.08,4,4,5,0,0,1,0,2,5,2,1.5,1.6,2,3,3,1,1
USA - MLS,Vancouver,2,5,5,5,6,1.7,1.13,10,6,3,3,1,1,2,5,1,1,2.2,1.3,4,3,1,1,1,1,3,0,4,5,1.31,1.0,6,3,2,2,0
USL Championship,Birmingham L.,0,2,4,5,7,1.06,1.39,2,10,4,1,1,0,1,0,4,5,0.7,1.0,2,7,0,1,0,0,1,4,1,2,1.5,1.88,0,3,4,0,1
USL Championship,Charleston,3,4,5,4,2,2.11,0.89,5,10,3,0,0,3,1,3,2,0,2.56,0.78,4,3,2,0,0,0,3,2,2,2,1.67,1.0,1,7,1,0,0
USL Championship,Colorado S.,0,1,3,10,2,1.19,1.38,4,4,6,2,0,0,0,0,5,1,0.83,0.83,2,3,1,0,0,0,1,3,5,1,1.4,1.7,2,1,5,2,0
USL Championship,Detroit City,0,1,7,3,6,1.18,1.29,6,2,7,2,0,0,0,3,2,2,1.14,1.0,4,0,2,1,0,0,1,4,1,4,1.2,1.5,2,2,5,1,0
USL Championship,El Paso,1,2,5,4,4,1.5,1.56,2,8,2,3,1,1,2,2,1,1,2.14,1.86,1,2,2,1,1,0,0,3,3,3,1.0,1.33,1,6,0,2,0
USL Championship,FC Tulsa,2,0,3,10,1,1.5,1.0,5,7,3,1,0,1,0,1,5,1,1.38,1.13,2,4,1,1,0,1,0,2,5,0,1.63,0.88,3,3,2,0,0
USL Championship,Hartford A.,1,1,2,4,7,1.0,1.4,4,5,4,0,2,0,1,0,4,3,0.88,0.88,3,3,2,0,0,1,0,2,0,4,1.14,2.0,1,2,2,0,2
USL Championship,Indy Eleven,1,2,4,8,1,1.63,1.75,4,4,2,4,2,1,1,3,3,1,1.78,1.67,3,1,2,2,1,0,1,1,5,0,1.43,1.86,1,3,0,2,1
USL Championship,Las Vegas L.,0,1,2,6,8,0.76,1.65,8,1,2,2,4,0,0,2,5,3,0.9,1.2,5,1,2,1,1,0,1,0,1,5,0.57,2.29,3,0,0,1,3
USL Championship,Lexington,0,0,5,7,5,1.0,1.35,5,5,5,1,1,0,0,4,2,3,1.11,1.0,3,4,1,1,0,0,0,1,5,2,0.88,1.75,2,1,4,0,1
USL Championship,Loudoun Utd,1,2,6,3,5,1.53,1.41,3,7,5,1,1,1,1,3,2,2,1.78,1.22,3,3,2,0,1,0,1,3,1,3,1.25,1.63,0,4,3,1,0
USL Championship,Louisville City,2,0,8,6,1,1.76,0.76,6,9,2,0,0,1,0,5,1,1,1.88,0.63,4,3,1,0,0,1,0,3,5,0,1.67,0.89,2,6,1,0,0
USL Championship,Miami FC,0,0,4,8,4,1.0,1.5,2,6,6,2,0,0,0,3,5,2,1.1,1.5,1,4,4,1,0,0,0,1,3,2,0.83,1.5,1,2,2,1,0
USL Championship,Monterey Bay,0,3,3,4,8,1.06,1.28,3,8,6,1,0,0,2,3,2,1,1.75,1.38,0,5,3,0,0,0,1,0,2,7,0.5,1.2,3,3,3,1,0
USL Championship,New Mexico,1,3,0,9,2,1.47,1.13,6,2,6,1,0,1,0,0,6,0,1.43,1.0,3,1,3,0,0,0,3,0,3,2,1.5,1.25,3,1,3,1,0
USL Championship,North Carolina,2,0,5,7,2,1.56,1.25,4,5,6,1,0,2,0,3,3,0,2.13,1.5,1,3,3,1,0,0,0,2,4,2,1.0,1.0,3,2,3,0,0
USL Championship,Oakland Roots,0,0,8,3,6,1.12,1.47,6,4,2,3,2,0,0,2,2,5,0.67,1.22,4,1,2,2,0,0,0,6,1,1,1.63,1.75,2,3,0,1,2
USL Championship,Orange County,2,2,3,2,6,1.47,1.47,3,5,4,3,0,2,1,3,0,2,2.13,1.63,1,3,2,2,0,0,1,0,2,4,0.71,1.29,2,2,2,1,0
USL Championship,Phoenix Rising,1,1,7,5,2,1.63,1.63,2,8,2,2,2,0,1,4,0,2,1.57,1.43,1,3,2,1,0,1,0,3,5,0,1.67,1.78,1,5,0,1,2
USL Championship,Pittsburgh,0,0,4,6,6,0.88,0.88,7,4,5,0,0,0,0,4,2,1,1.43,0.71,4,1,2,0,0,0,0,0,4,5,0.44,1.0,3,3,3,0,0
USL Championship,Rhode Island,0,2,2,4,9,0.82,1.06,5,6,6,0,0,0,0,1,2,5,0.5,0.88,2,5,1,0,0,0,2,1,2,4,1.11,1.22,3,1,5,0,0
USL Championship,Sacramento R.,1,1,5,4,5,1.38,0.75,7,6,3,0,0,1,1,2,2,3,1.56,0.67,4,4,1,0,0,0,0,3,2,2,1.14,0.86,3,2,2,0,0
USL Championship,San Antonio,0,3,4,6,3,1.44,1.31,6,3,5,0,2,0,2,1,6,0,1.56,1.0,4,1,4,0,0,0,1,3,0,3,1.29,1.71,2,2,1,0,2
USL Championship,Tampa Bay,0,1,3,8,4,1.06,1.56,1,7,6,2,0,0,1,2,3,1,1.43,2.0,0,2,3,2,0,0,0,1,5,3,0.78,1.22,1,5,3,0,0
USA - USL League One,Alta,2,1,5,5,3,1.69,1.31,4,5,5,2,0,1,1,3,3,2,1.6,0.9,3,5,2,0,0,1,0,2,2,1,1.83,2.0,1,0,3,2,0
USA - USL League One,Charlotte I.,1,3,2,8,2,1.56,1.25,4,6,4,2,0,0,2,0,5,1,1.38,0.88,3,3,2,0,0,1,1,2,3,1,1.75,1.63,1,3,2,2,0
USA - USL League One,Chattanooga RW,0,2,6,5,2,1.53,1.0,6,5,2,2,0,0,2,2,3,1,1.63,0.63,4,3,1,0,0,0,0,4,2,1,1.43,1.43,2,2,1,2,0
USA - USL League One,Forward Madison,0,1,1,8,4,0.93,1.21,1,9,4,0,0,0,1,0,4,2,1.0,1.0,1,5,1,0,0,0,0,1,4,2,0.86,1.43,0,4,3,0,0
USA - USL League One,Greenville,0,4,2,5,6,1.24,1.35,4,8,1,3,1,0,2,2,3,2,1.44,1.11,3,4,1,0,1,0,2,0,2,4,1.0,1.63,1,4,0,3,0
USA - USL League One,Naples,0,2,4,8,2,1.38,1.25,4,7,3,1,1,0,1,4,1,2,1.5,0.88,2,5,1,0,0,0,1,0,7,0,1.25,1.63,2,2,2,1,1
USA - USL League One,One Knoxville,0,2,3,7,1,1.46,0.92,4,7,1,1,0,0,2,0,2,0,2.0,0.75,1,3,0,0,0,0,0,3,5,1,1.22,1.0,3,4,1,1,0
USA - USL League One,Portland Hearts,0,2,2,8,3,1.2,1.07,3,8,4,0,0,0,2,1,2,1,1.67,1.17,0,5,1,0,0,0,0,1,6,2,0.89,1.0,3,3,3,0,0
USA - USL League One,Richmond K.,3,2,1,4,6,1.5,1.75,2,4,7,2,1,1,2,0,3,2,1.63,1.88,1,2,3,1,1,2,0,1,1,4,1.38,1.63,1,2,4,1,0
USA - USL League One,Spokane V.,2,1,3,5,5,1.38,0.94,6,7,1,2,0,1,1,2,3,2,1.56,0.89,2,6,1,0,0,1,0,1,2,3,1.14,1.0,4,1,0,2,0
USA - USL League One,Texoma,0,2,4,6,4,1.25,1.63,3,6,3,2,2,0,2,3,2,3,1.4,1.8,2,2,3,2,1,0,0,1,4,1,1.0,1.33,1,4,0,0,1
USA - USL League One,Tormenta,0,0,8,4,3,1.33,1.87,1,5,5,3,1,0,0,4,3,2,1.22,1.78,1,3,3,1,1,0,0,4,1,1,1.5,2.0,0,2,2,2,0
USA - USL League One,Union Omaha,0,2,2,7,3,1.21,1.71,3,3,4,3,1,0,1,1,2,0,1.75,2.0,1,0,2,0,1,0,1,1,5,3,1.0,1.6,2,3,2,3,0
USA - USL League One,Westchester SC,1,2,4,6,2,1.6,2.0,1,6,3,3,2,0,1,3,2,1,1.57,2.14,1,2,1,2,1,1,1,1,4,1,1.63,1.88,0,4,2,1,1
Venezuela - Primera Division - Apertura,A. Anzoategui,1,3,1,2,6,1.31,0.92,4,7,1,1,0,0,2,1,1,3,1.29,0.57,3,4,0,0,0,1,1,0,1,3,1.33,1.33,1,3,1,1,0
Venezuela - Primera Division - Apertura,Carabobo,0,1,2,6,4,1.0,0.54,9,2,1,1,0,0,0,1,3,2,0.83,0.33,5,0,1,0,0,0,1,1,3,2,1.14,0.71,4,2,0,1,0
Venezuela - Primera Division - Apertura,Caracas,0,2,1,4,6,0.92,1.15,5,5,0,2,1,0,0,0,3,3,0.5,0.83,4,1,0,0,1,0,2,1,1,3,1.29,1.43,1,4,0,2,0
Venezuela - Primera Division - Apertura,D. La Guaira,1,1,4,5,2,1.54,0.85,4,7,2,0,0,1,0,2,1,2,1.5,0.67,3,2,1,0,0,0,1,2,4,0,1.57,1.0,1,5,1,0,0
Venezuela - Primera Division - Apertura,D. Tachira,2,1,2,4,4,1.46,0.77,6,5,1,1,0,1,0,1,4,1,1.43,0.43,4,3,0,0,0,1,1,1,0,3,1.5,1.17,2,2,1,1,0
Venezuela - Primera Division - Apertura,E. Merida,0,1,3,6,3,1.15,1.77,4,0,6,1,2,0,1,2,3,1,1.43,1.57,3,0,2,1,1,0,0,1,3,2,0.83,2.0,1,0,4,0,1
Venezuela - Primera Division - Apertura,Metropolitanos,1,1,3,4,4,1.31,1.38,3,5,3,1,1,1,1,2,0,2,1.83,1.0,2,2,2,0,0,0,0,1,4,2,0.86,1.71,1,3,1,1,1
Venezuela - Primera Division - Apertura,Monagas,1,1,4,2,5,1.31,1.62,1,6,4,1,1,0,1,3,2,1,1.57,2.0,0,3,2,1,1,1,0,1,0,4,1.0,1.17,1,3,2,0,0
Venezuela - Primera Division - Apertura,Portuguesa,1,0,3,4,5,1.08,1.08,4,5,3,1,0,1,0,2,2,2,1.43,1.43,1,3,2,1,0,0,0,1,2,3,0.67,0.67,3,2,1,0,0
Venezuela - Primera Division - Apertura,Puerto Cabello,0,2,2,4,5,1.08,0.77,7,3,2,1,0,0,1,1,3,1,1.33,1.0,3,1,1,1,0,0,1,1,1,4,0.86,0.57,4,2,1,0,0
Venezuela - Primera Division - Apertura,Rayo Zuliano,0,0,4,5,4,1.0,1.31,4,5,1,2,1,0,0,2,4,1,1.14,0.57,4,2,1,0,0,0,0,2,1,3,0.83,2.17,0,3,0,2,1
Venezuela - Primera Division - Apertura,UCV,0,0,4,7,2,1.15,0.69,7,4,1,1,0,0,0,1,4,1,1.0,1.0,2,3,0,1,0,0,0,3,3,1,1.29,0.43,5,1,1,0,0
Venezuela - Primera Division - Apertura,Yaracuyanos,0,1,3,3,6,0.92,1.85,2,2,6,2,1,0,1,2,1,3,1.14,1.71,2,0,3,2,0,0,0,1,2,3,0.67,2.0,0,2,3,0,1
Venezuela - Primera Division - Apertura,Zamora,0,1,2,3,7,0.77,1.31,3,3,7,0,0,0,1,1,1,3,1.0,1.17,1,3,2,0,0,0,0,1,2,4,0.57,1.43,2,0,5,0,0
Vietnam - V League,Binh Dinh,0,0,5,12,9,0.85,1.65,5,9,6,3,3,0,0,4,6,3,1.08,1.85,3,3,4,0,3,0,0,1,6,6,0.62,1.46,2,6,2,3,0
Vietnam - V League,Binh Duong,1,1,7,10,7,1.19,1.54,5,12,2,4,3,1,1,3,6,2,1.46,1.46,3,5,2,2,1,0,0,4,4,5,0.92,1.62,2,7,0,2,2
Vietnam - V League,Cong An Nhan,3,6,3,8,6,1.73,0.88,9,13,3,0,1,1,3,2,3,4,1.54,0.85,6,5,1,0,1,2,3,1,5,2,1.92,0.92,3,8,2,0,0
Vietnam - V League,Da Nang,0,1,6,9,10,0.92,1.62,5,11,4,4,2,0,1,1,8,3,1.0,1.0,4,6,2,1,0,0,0,5,1,7,0.85,2.23,1,5,2,3,2
Vietnam - V League,Gia Lai,2,1,6,11,6,1.31,1.58,7,7,6,4,2,1,1,4,4,3,1.46,1.08,5,4,2,2,0,1,0,2,7,3,1.15,2.08,2,3,4,2,2
Vietnam - V League,Ha Noi,2,5,6,10,3,1.77,0.96,9,10,6,1,0,1,3,2,5,2,1.77,1.15,3,6,3,1,0,1,2,4,5,1,1.77,0.77,6,4,3,0,0
Vietnam - V League,Hai Phong,1,0,9,7,9,1.12,1.04,9,9,6,2,0,1,0,5,4,3,1.38,0.77,7,3,2,1,0,0,0,4,3,6,0.85,1.31,2,6,4,1,0
Vietnam - V League,Ho Chi Minh,0,0,5,9,12,0.73,1.38,7,8,7,3,1,0,0,2,4,7,0.62,1.08,5,3,4,1,0,0,0,3,5,5,0.85,1.69,2,5,3,2,1
Vietnam - V League,Hong Linh Ha T.,0,2,3,12,9,0.92,0.77,10,12,4,0,0,0,1,2,5,5,0.92,0.69,6,5,2,0,0,0,1,1,7,4,0.92,0.85,4,7,2,0,0
Vietnam - V League,Nam Dinh,4,5,6,5,6,1.96,0.69,11,13,1,1,0,3,2,3,3,2,2.31,0.85,4,8,0,1,0,1,3,3,2,4,1.62,0.54,7,5,1,0,0
Vietnam - V League,Quang Nam,1,3,2,10,10,1.04,1.38,7,8,7,2,2,0,2,1,6,4,1.08,1.54,3,3,5,1,1,1,1,1,4,6,1.0,1.23,4,5,2,1,1
Vietnam - V League,Song Lam Nghe,0,1,2,15,8,0.85,1.38,7,9,6,2,2,0,1,1,7,4,0.92,1.23,5,4,2,1,1,0,0,1,8,4,0.77,1.54,2,5,4,1,1
Vietnam - V League,Thanh Hoa,1,2,3,16,4,1.23,1.27,4,14,6,1,1,0,2,1,10,0,1.38,1.38,1,8,3,0,1,1,0,2,6,4,1.08,1.15,3,6,3,1,0
Vietnam - V League,Viettel,2,1,10,9,4,1.65,1.12,8,8,9,1,0,1,0,6,4,2,1.69,1.0,4,5,4,0,0,1,1,4,5,2,1.62,1.23,4,3,5,1,0
Vietnam - V League 2,Ba Ria Vung Tau,1,2,1,5,11,0.85,1.65,3,8,5,2,2,1,1,0,3,5,1.0,1.2,2,5,2,1,0,0,1,1,2,6,0.7,2.1,1,3,3,1,2
Vietnam - V League 2,Binh Phuoc,0,3,8,5,4,1.5,0.65,11,6,2,1,0,0,2,6,1,1,1.9,0.8,4,4,2,0,0,0,1,2,4,3,1.1,0.5,7,2,0,1,0
Vietnam - V League 2,Dong Nai,1,0,1,7,11,0.65,1.0,9,6,2,2,1,1,0,0,3,6,0.7,0.7,5,4,0,1,0,0,0,1,4,5,0.6,1.3,4,2,2,1,1
Vietnam - V League 2,Dong Thap,0,1,3,5,11,0.7,0.8,8,8,4,0,0,0,1,1,3,5,0.8,0.7,5,3,2,0,0,0,0,2,2,6,0.6,0.9,3,5,2,0,0
Vietnam - V League 2,Ho Chi Minh B,0,1,3,5,11,0.7,1.05,8,6,3,3,0,0,1,2,3,4,1.0,0.9,4,4,1,1,0,0,0,1,2,7,0.4,1.2,4,2,2,2,0
Vietnam - V League 2,Hoa Binh,0,0,3,9,8,0.75,1.0,8,6,5,0,1,0,0,3,3,4,0.9,0.8,6,2,1,0,1,0,0,0,6,4,0.6,1.2,2,4,4,0,0
Vietnam - V League 2,Hue,0,1,4,5,10,0.8,1.5,3,8,5,4,0,0,0,2,2,6,0.6,1.4,2,4,2,2,0,0,1,2,3,4,1.0,1.6,1,4,3,2,0
Vietnam - V League 2,Long An,0,0,1,7,12,0.45,1.0,9,4,5,2,0,0,0,1,5,4,0.7,0.9,4,3,3,0,0,0,0,0,2,8,0.2,1.1,5,1,2,2,0
Vietnam - V League 2,PVF-CAND,1,5,2,6,6,1.45,0.6,13,3,3,1,0,0,4,1,2,3,1.6,0.7,6,2,1,1,0,1,1,1,4,3,1.3,0.5,7,1,2,0,0
Vietnam - V League 2,Phu Dong,1,4,8,7,0,2.0,0.15,17,3,0,0,0,1,2,4,3,0,2.2,0.1,9,1,0,0,0,0,2,4,4,0,1.8,0.2,8,2,0,0,0
Vietnam - V League 2,S. Khanh Hoa,0,0,5,6,9,0.8,1.25,4,9,5,2,0,0,0,3,1,6,0.7,1.0,2,6,2,0,0,0,0,2,5,3,0.9,1.5,2,3,3,2,0
Wales - Cymru Premier,Aberystwyth,1,4,1,10,16,0.88,2.22,2,9,9,7,5,0,2,1,7,6,0.94,1.88,2,6,4,2,2,1,2,0,3,10,0.81,2.56,0,3,5,5,3
Wales - Cymru Premier,Bala Town,0,5,8,7,12,1.19,1.34,12,4,11,4,1,0,3,3,3,7,1.13,1.06,7,2,6,1,0,0,2,5,4,5,1.25,1.63,5,2,5,3,1
Wales - Cymru Premier,Barry,3,4,9,12,4,1.72,1.59,4,15,6,4,3,1,4,3,7,1,1.88,1.38,2,8,5,0,1,2,0,6,5,3,1.56,1.81,2,7,1,4,2
Wales - Cymru Premier,Briton Ferry,2,3,6,15,6,1.44,2.03,6,8,8,4,6,1,2,3,7,3,1.44,1.88,3,5,4,1,3,1,1,3,8,3,1.44,2.19,3,3,4,3,3
Wales - Cymru Premier,Caernarfon,2,6,7,12,5,1.66,1.59,7,11,8,2,4,1,5,2,6,2,1.88,1.88,3,4,6,0,3,1,1,5,6,3,1.44,1.31,4,7,2,2,1
Wales - Cymru Premier,Cardiff MU,2,2,9,10,9,1.34,1.44,6,14,7,4,1,1,2,5,5,3,1.56,1.56,3,7,3,2,1,1,0,4,5,6,1.13,1.31,3,7,4,2,0
Wales - Cymru Premier,Connahs Quay,3,4,3,13,9,1.47,1.09,10,11,9,2,0,2,2,1,6,5,1.56,1.0,5,6,5,0,0,1,2,2,7,4,1.38,1.19,5,5,4,2,0
Wales - Cymru Premier,Flint,2,3,11,9,7,1.5,1.94,6,8,9,4,5,1,3,5,5,2,1.75,1.19,5,5,5,0,1,1,0,6,4,5,1.25,2.69,1,3,4,4,4
Wales - Cymru Premier,Haverfordwest,2,3,4,13,10,1.22,0.81,15,12,3,1,1,2,2,0,7,5,1.38,0.75,8,5,2,1,0,0,1,4,6,5,1.06,0.88,7,7,1,0,1
Wales - Cymru Premier,Newtown,1,0,10,12,9,1.13,2.03,4,8,10,5,5,1,0,7,4,4,1.38,2.38,2,3,4,3,4,0,0,3,8,5,0.88,1.69,2,5,6,2,1
Wales - Cymru Premier,Penybont,3,4,11,8,6,1.75,1.0,12,13,3,3,1,2,3,3,4,4,1.75,0.69,7,7,2,0,0,1,1,8,4,2,1.75,1.31,5,6,1,3,1
Wales - Cymru Premier,The New Saints,11,4,10,5,2,2.78,0.97,11,13,6,2,0,5,3,7,1,0,2.94,0.94,6,6,3,1,0,6,1,3,4,2,2.63,1.0,5,7,3,1,0
